A	Agilent Technologies
AA	Alcoa
AABA	Altaba
AAC	AAC Holdings
AAL	American Airlines
AAMC	Altisource Asset Management
AAME	Atlantic American
AAN	Aaron's
AAOI	Applied Optoelectronics
AAON	AAON
AAP	Advance Auto Parts
AAPL	Apple
AAT	American Assets Trust
AAU	Almaden Minerals
AAWW	Atlas Air Worldwide
AAXN	Axon Enterprise
AB	AllianceBernstein
ABB	ABB Ltd
ABBV	AbbVie
ABC	AmerisourceBergen
ABCB	Ameris Bancorp
ABDC	Alcentra Capital
ABEO	Abeona Therapeutics
ABEV	Ambev
ABG	Asbury Automotive
ABIL	Ability Inc
ABIO	ARCA biopharma
ABM	ABM Industries
ABMD	ABIOME
ABR	Arbor Realty Trust
ABT	Abbott Laboratories
ABTX	Allegiance Bancshares
ABUS	Arbutus Biopharma
AC	Associated Capital Group
ACA	Arcosa
ACAD	ACADIA Pharmaceuticals
ACAM	Acamar Partners Acquisition
ACB	Aurora Cannabis
ACBI	Atlantic Capital Bancshares
ACC	American Campus Communities
ACCO	Acco Brands
ACER	Acer Therapeutics
ACGL	Arch Capital Group
ACH	Aluminum Corporation of China
ACHC	Acadia Healthcare Company
ACHN	Achillion Pharmaceuticals
ACHV	Achieve Life Sciences
ACIA	Acacia Communications
ACIU	AC Immune
ACIW	ACI Worldwide
ACLS	Axcelis Technologies
ACM	AECOM
ACMR	ACM Research
ACN	Accenture
ACNB	ACNB
ACOR	Acorda Therapeutics
ACP	Aberdeenome Credit Strategies Fund
ACRE	Ares Commercial Real Estate
ACRS	Aclaris Therapeutics
ACRX	AcelRx Pharmaceuticals
ACST	Acasti Pharma
ACT	AdvisorShares Vice ETF
ACTG	Acacia Research
ACTT	Act II Global Acquisition
ACU	Acme United
ACV	AllianzGI Diversifiedome & Convertible Fund
ACY	AeroCentury
ADAP	Adaptimmune Therapeutics
ADBE	Adobe
ADC	Agree Realty
ADES	Advanced Emissions Solutions
ADI	Analog Devices
ADIL	Adial Pharmaceuticals
ADM	Archer-Daniels-Midland
ADMA	ADMA Biologics
ADMP	Adamis Pharmaceuticals
ADMS	Adamas Pharmaceuticals
ADNT	Adient
ADOM	ADOMANI
ADP	Automatic Data Processing
ADRO	Aduro Biotech
ADS	Alliance Data Systems
ADSK	Autodesk
ADSW	Advanced Disposal Services
ADT	ADT
ADTN	ADTRAN
ADUS	Addus HomeCare
ADVM	Adverum Biotechnologies
ADX	Adams Diversified Equity Fund
ADXS	Advaxis
AE	Adams Resources & Energy
AEB	Aegon
AEE	Ameren
AEF	Aberdeen Emerging Markets Equityome Fund
AEGN	Aegion
AEHR	Aehr Test Systems
AEIS	Advanced Energy Industries
AEL	American Equity Investment Life
AEM	Agnico Eagle Mines
AEMD	Aethlon Medical
AEO	American Eagle Outfitters
AEP	American Electric Power
AER	Aercap
AERI	Aerie Pharmaceuticals
AES	AES
AETI	American Electric Technologies
AEY	ADDvantage Technologies
AEYE	AudioEye
AEZS	AEterna Zentaris
AFB	Alliance National Municipalome Fund
AFC	Ares Capital
AFG	American Financial Group
AFH	Atlas Financial
AFI	Armstrong Flooring
AFIN	American Finance Trust
AFL	Aflac
AFMD	Affimed
AFT	Apollo Senior Floating Rate Fund
AG	First Majestic Silver
AGBAU	AGBA Acquisition
AGCO	AGCO
AGD	Aberdeen Global Dynamic Dividend Fund
AGE	AgeX Therapeutics
AGEN	Agenus
AGFS	AgroFresh Solutions
AGI	Alamos Gold
AGIO	Agios Pharmaceuticals
AGLE	Aeglea BioTherapeutics
AGM	Federal Agricultural Mortgage
AGMH	AGM Group
AGN	Allergan
AGNC	AGNC Investment
AGO	Assured Guaranty
AGR	Avangrid
AGRO	Adecoagro
AGRX	Agile Therapeutics
AGS	PlayAGS
AGTC	Applied Genetic Technologies
AGX	Argan
AGYS	Agilysys
AHC	A.H. Belo
AHH	Armada Hoffler Properties
AHL	Aspen Insurance
AHPI	Allied Healthcare Products
AHT	Ashford Hospitality Trust
AI	Arlington Asset Investment
AIF	Apollo Tacticalome Fund
AIG	AIG
AIG	American International Group
AIHS	Senmiao Technology Limited
AIMC	Altra Industrial Motion
AIMT	Aimmune Therapeutics
AIN	Albany International
AINC	Ashford
AINV	Apollo Investment
AIPT	Precision Therapeutics
AIR	AAR
AIRG	Airgain
AIRI	Air Industries Group
AIRT	Air T
AIT	Applied Industrial Technologies
AITB	AIT Therapeutics
AIV	Apartment Investment and Management Company
AIZ	Assurant, Inc.
AJG	Arthur J. Gallagher
AJRD	Aerojet Rocketdyne
AJX	Great Ajax 
AKAM	Akamai
AKBA	Akebia Therapeutics
AKCA	Akcea
AKER	Akers Biosciences
AKG	Asanko Gold
AKO	Embotelladora Andina
AKR	Acadia Realty Trust
AKRX	Akorn
AKS	AK Steel Holding
AKTS	Akoustis Technologies
AKTX	Akari Therapeutics
AL	Air Lease
ALAC	Alberton Acquisition
ALB	Albemarle
ALBO	Albireo Pharma
ALC	Alcon
ALCO	Alico
ALDR	Alder BioPharmaceuticals
ALDX	Aldeyra Therapeutics
ALE	Allete
ALEC	Alector
ALEX	Alexander & Baldwin
ALG	Alamo
ALGN	Align Technology
ALGR	Allegro Merger
ALGT	Allegiant Travel
ALIM	Alimera Sciences
ALJJ	ALJ Regional
ALK	Alaska Air
ALKS	Alkermes
ALL	Allstate
ALLE	Allegion
ALLK	Allakos
ALLO	Allogene
ALLT	Allot
ALLY	Ally Financial
ALNA	Allena Pharmaceuticals
ALNY	Alnylam
ALO	Alio Gold
ALOT	AstroNova
ALP	Alabama Power
ALPN	Alpine Immune Sciences
ALRM	Alarm.com
ALRN	Aileron Therapeutics
ALSK	Alaska Communications Systems
ALSN	Allison Transmission
ALT	Altimmune
ALTM	Altus Midstream Company
ALTR	Altair Engineering
ALV	Autoliv
ALX	Alexander's
ALXN	Alexion Pharmaceuticals
ALYA	Alithya Group
AM	Antero Midstream
AMAG	AMAG Pharmaceuticals
AMAL	Amalgamated Bank
AMAT	Applied Materials
AMBA	Ambarella
AMBC	Ambac Financial Group
AMBO	Ambow Education
AMBR	Amber Road
AMC	AMC Entertainment
AMCI	AMCI Acquisition
AMCN	AirMedia Group
AMCX	AMC Networks
AMD	Advanced Micro Devices
AME	AMTEK
AMED	Amedisys
AMEH	Apollo Medical
AMG	Affiliated Managers Group
AMGN	Amgen
AMH	American Homes 4 Rent
AMID	American Midstream Partners
AMKR	Amkor Technology
AMN	AMN Healthcare Services
AMNB	American National Bankshares
AMOT	Allied Motion Technologies
AMOV	America Movil
AMP	AMERIPRISE
AMPE	Ampio Pharmaceuticals
AMPH	Amphastar Pharmaceuticals
AMR	Alta Mesa Resources
AMRB	American River Bankshares
AMRC	Ameresco
AMRH	Ameri Holdings
AMRK	A-Mark Precious Metals
AMRN	Amarin
AMRS	Amyris
AMRX	Amneal Pharmaceuticals
AMS	American Shared Hospital Services
AMSC	American Superconductor
AMSF	AMERISAFE
AMSWA	American Software
AMT	American Tower
AMTB	Mercantil Bank
AMTD	TD Ameritrade
AMTX	Aemetis
AMWD	American Woodmark
AMZN	Amazon.com
AMZN	Amazon
AN	AutoNation
ANAB	AnaptysBio
ANAT	American National Insurance Company
ANCN	Anchiano Therapeutics
ANDA	Andina Acquisition
ANDE	The Andersons
ANDX	Andeavor Logistics
ANET	Arista Networks
ANF	Abercrombie & Fitch
ANFI	Amira Nature Foods
ANGI	ANGI Homeservices
ANGO	AngioDynamics
ANH	Anworth Mortgage Asset
ANIK	Anika Therapeutics
ANIP	ANI Pharmaceuticals
ANIX	Anixa Biosciences
ANSS	ANSYS
ANTM	Anthem
ANY	Sphere 3D
AOBC	American Outdoor Brands
AOD	Aberdeen Total Dynamic Dividend Fund
AON	Aon
AOS	A.O Smith
AOSL	Alpha and Omega Semiconductor Limited
AP	Ampco-Pittsburgh
APA	Apache
APAM	Artisan Partners Asset Management
APC	Anadarko Petroleum
APD	Air Products and Chemicals
APDN	Applied DNA Sciences
APEI	American Public Education
APEN	Apollo Endosurgery
APH	Amphenol
APHA	Aphria
APLE	Apple Hospitality REIT
APLS	Apellis Pharmaceuticals
APLT	Applied Therapeutics
APM	Aptorum Group
APO	Apollo Global Management
APOG	Apogee Enterprises
APOP	Cellect Biotechnology
APPF	AppFolio
APPN	Appian
APPS	Digital Turbine
APRN	Blue Apron
APT	Alpha Pro Tech
APTO	Aptose Biosciences
APTS	Preferred Apartment Communities
APTV	Aptiv
APTX	Aptinyx
APU	AmeriGas Partners
APVO	Aptevo Therapeutics
APWC	Asia Pacific Wire & Cable Limited
APY	Apergy
APYX	Apyx Medical
AQ	Aquantia
AQB	AquaBounty Technologies
AQMS	Aqua Metals
AQN	Algonquin Power & Utilities
AQST	Aquestive Therapeutics
AQUA	Evoqua Water Technologies
AQXP	Aquinox Pharmaceuticals
AR	Antero Resources
ARA	American Renal Associates
ARAV	Aravive
ARAY	Accurayorporated
ARC	ARC Document Solutions
ARCB	ArcBest
ARCE	Arco Platform
ARCH	Arch Coal
ARCI	Appliance Recycling Centers of America
ARCO	Arcos Dorados
ARCT	Arcturus Therapeutics
ARCW	ARC Group Worldwide
ARD	Ardagh
ARDC	Ares Dynamic Credit Allocation Fund
ARDS	Aridis Pharmaceuticals
ARDX	Ardelyx
ARE	Alexandria Real Estate Equities
AREC	American Resources
ARES	Ares Management
AREX	Approach Resources
ARGD	Argo Group International
ARGX	argenx SE
ARI	Apollo Commercial Real Estate Finance
ARKR	Ark Restaurants
ARL	American Realty Investors
ARLO	Arlo Technologies
ARLP	Alliance Resource Partners
ARMK	Aramark
ARMP	Armata Pharmaceuticals
ARNA	Arena Pharmaceuticals
ARNC	Arconic
AROC	Archrock
AROW	Arrow Financial
ARPO	Aerpio Pharmaceuticals
ARQL	ArQule
ARR	ARMOUR Residential REIT
ARRY	Array BioPharma
ARTNA	Artesian Resources
ARTW	Art's-Way Manufacturing
ARTX	Arotech
ARVN	Arvinas
ARW	Arrow Electronics
ARWR	Arrowhead Pharmaceuticals
ARYA	ARYA Sciences Acquisition
ASA	ASA Gold and Precious Metals Limited
ASB	Associated Banc-Corp
ASC	Ardmore Shipping
ASCMA	Ascent Capital Group
ASFI	Asta Funding
ASGN	ASGNorporated
ASH	Ashland Global
ASIX	AdvanSix
ASLN	ASLAN Pharmaceuticals Limited
ASM	Avino Silver
ASMB	Assembly Biosciences
ASML	ASML Holding
ASNA	Ascena Retail Group
ASND	Ascendis Pharma
ASPN	Aspen Aerogels
ASPS	Altisource Portfolio Solutions
ASPU	Aspen Group
ASR	Grupo Aeroportuario del Sureste
ASRT	Assertio Therapeutics
ASRV	AmeriServ Financial
ASTC	Astrotech
ASTE	Astec Industries
ASUR	Asure Software
ASV	ASV Holdings
ASYS	Amtech Systems
AT	Atlantic Power
ATAI	ATA
ATAX	America First Multifamily Investors
ATEC	Alphatec Holdings
ATEN	A10 Networks
ATGE	Adtalem Global Education
ATH	Athene Holding
ATHE	Alterity Therapeutics Limited
ATHM	Autohome
ATHX	Athersys
ATI	Allegheny Technologiesorporated
ATIF	ATIF
ATIS	Attis Industries
ATKR	Atkore International Group
ATLC	Atlanticus
ATLO	Ames National
ATNI	ATN International
ATNM	Actinium Pharmaceuticals
ATNX	Athenex
ATO	Atmos Energy
ATOM	Atomeraorporated
ATOS	Atossa Genetics
ATR	AptarGroup
ATRA	Atara Biotherapeutics
ATRC	AtriCure
ATRI	Atrion
ATRO	Astronics
ATRS	Antares Pharma
ATSG	Air Transport Services Group
ATTO	Atento
ATU	Actuant
ATUS	Altice USA
ATV	Acorn International
ATVI	Activision Blizzard
ATXI	Avenue Therapeutics
AU	AngloGold Ashanti Limited
AUB	Atlantic Union Bankshares
AUBN	Auburn National Bancorporation
AUDC	AudioCodes
AUG	Auryn Resources
AUMN	Golden Minerals Company
AUO	AU Optronics Corp
AUPH	Aurinia Pharmaceuticals
AUTL	Autolus Therapeutics
AUTO	AutoWeb
AUY	Yamana Gold
AVA	Avista
AVAL	Grupo Aval Acciones y Valores
AVAV	AeroVironment
AVB	AvalonBay Communities
AVCO	Avalon GloboCare
AVD	American Vanguard
AVDL	Avadel Pharmaceuticals
AVDR	Avedro
AVEO	AVEO Pharmaceuticals
AVGO	Broadcom
AVGR	Avinger
AVH	Avianca
AVID	Avid Technology
AVK	Advent Claymore Convertible Securities andome Fund
AVLR	Avalara
AVNS	Avanos Medical
AVNW	Aviat Networks
AVP	Avon Products
AVRO	AVROBIO
AVT	Avnet
AVTR	Avantor
AVX	AVX
AVXL	Anavex Life Sciences
AVY	Avery Dennison
AVYA	Avaya
AWF	Alliance World Dollar Government Fund
AWI	Armstrong World Industries
AWK	American Water Works
AWP	Aberdeen Global Premier Properties Fund
AWR	American States Water Company
AWRE	Aware Inc
AWSM	Cool Holdings
AWX	Avalon Holdings
AX	Axos Financial
AXAS	Abraxas Petroleum
AXDX	Accelerate Diagnostics
AXE	Anixter International
AXGN	AxoGen
AXGT	Axovant Gene Therapies
AXL	American Axle & Manufacturing
AXLA	Axcella Health
AXNX	Axonics Modulation Technologies
AXP	American Express Company
AXR	AMREP
AXS	Axis Capital
AXSM	Axsome Therapeutics
AXTA	Axalta Coating Systems
AXTI	AXT
AXU	Alexco Resource
AY	Atlantica Yield
AYI	Acuity Brands
AYR	Aircastle Limited
AYTU	Aytu BioScience
AYX	Alteryx
AZN	Astrazeneca
AZO	AutoZone
AZPN	Aspen Technology
AZRE	Azure Power Global Limited
AZRX	AzurRx BioPharma
AZUL	Azul
AZZ	AZZ
B	Barnes Group
BA	Boeing
BABA	Alibaba Group
BABY	Natus Medicalorporated
BAC	Bank of America
BAH	Booz Allen Hamilton
BAM	Brookfield Asset Management
BANC	Banc of California
BAND	Bandwidth Inc
BANF	BancFirst
BANR	Banner
BANX	StoneCastle Financial
BAP	Credicorp
BAS	Basic Energy Services
BASI	Bioanalytical Systems
BATRA	Liberty Media
BAX	Baxter
BB	BlackBerry
BBBY	Bed Bath & Beyond
BBCP	Concrete Pumping Holdings
BBD	Banco Bradesco
BBDC	Barings BDC
BBGI	Beasley Broadcast Group
BBL	BHP Group Plc
BBN	BalckRock Taxable Municipal Bond Trust
BBSI	Barrett Business Services
BBT	BB&T
BBU	Brookfield Business Partners
BBVA	Banco Bilbao Viscaya Argentaria
BBW	Build-A-Bear Workshop
BBX	BBX Capital
BBY	Best Buy
BC	Brunswick
BCBP	BCB Bancorp
BCC	Boise Cascade
BCE	BCE
BCEI	Bonanza Creek Energy
BCH	Banco De Chile
BCLI	Brainstorm Cell Therapeutics
BCML	BayCom Corp
BCO	Brink's
BCOM	B Communications
BCOR	Blucora
BCOV	Brightcove
BCOW	1895 Bancorp of Wisconsin
BCPC	Balchem
BCRH	Blue Capital Reinsurance
BCRX	BioCryst Pharmaceuticals
BCS	Barclays
BCSF	Bain Capital Specialty Finance
BCTF	Bancorp 34
BCV	Bancroft Fund
BCYC	Bicycle Therapeutics
BDC	Belden
BDGE	Bridge Bancorp
BDL	Flanigan's Enterprises
BDN	Brandywine Realty Trust
BDR	Blonder Tongue Laboratories
BDSI	BioDelivery Sciences International
BDX	Becton, Dickinson and Company
BE	Bloom Energy
BEAT	BioTelemetry
BECN	Beacon Roofing Supply
BEDU	Bright Scholar Education
BEER	Bricktown Restaurant
BELFA	Bel Fuse
BEN	Franklin Resources
BEP	Brookfield Renewable Partners
BERY	Berry Global
BEST	BEST Inc.
BF.A	Brown Forman
BFAM	Bright Horizons Family Solutions
BFC	Bank First National
BFIN	BankFinancial
BFR	BBVA Banco Frances
BFRA	Biofrontera
BFS	Saul Centers
BFST	Business First Bancshares
BG	Bunge Limited
BGCP	BGC Partners
BGFV	Big 5 Sporting Goods
BGG	Briggs & Stratton
BGH	Babson Global Short Duration High Yield Fund
BGI	Birks Group
BGNE	BeiGene
BGS	B&G Foods
BGSF	BG Staffing
BH	Biglari Holdings
BHB	Bar Harbor Bankshares
BHC	Bausch Health Companies
BHE	Benchmark Electronics
BHF	Brighthouse Financial
BHGE	Baker Hughes
BHLB	Berkshire Hills Bancorp
BHP	BHP Group
BHR	Braemar Hotels & Resorts
BHTG	BioHiTech Global
BHVN	Biohaven Pharmaceutical
BID	Sotheby's
BIDU	Baidu
BIF	USLIFEome Fund
BIG	Big Lots
BIIB	Biogen
BILI	Bilibili
BIMI	NF Energy Saving
BIO	Bio-Rad Laboratories
BIOC	Biocept
BIOS	BioScrip
BIOX	Bioceres Crop Solutions
BIP	Brookfield Infrastructure Partners
BIQI	BIQI International
BITA	Bitauto
BJ	BJ's Wholesale Club
BJRI	BJ's Restaurants
BK	BNY Mellon
BK	Bank Of New York Mellon
BKCH	AdvisorShares Sabretooth ETF
BKD	Brookdale Senior Living
BKE	Buckle
BKEP	Blueknight Energy Partners
BKH	Black Hills
BKI	Black Knight
BKJ	Bancorp of New Jersey
BKNG	Booking Holdings
BKS	Barnes & Noble
BKSC	Bank of South Carolina
BKTI	BK Technologies
BKU	BankUnited
BKYI	BIO-key International
BL	BlackLine
BLBD	Blue Bird
BLCM	Bellicum Pharmaceuticals
BLD	TopBuild
BLDP	Ballard Power Systems
BLDR	Builders FirstSource
BLFS	BioLife Solutions
BLIN	Bridgeline Digital
BLK	BlackRock
BLKB	Blackbaud
BLL	Ball Corporation
BLMN	Bloomin' Brands
BLNK	Blink Charging
BLPH	Bellerophon Therapeutics
BLRX	BioLineRx
BLUE	bluebird bio
BLX	Banco Latinoamericano de Comercio Exterior
BMA	Macro Bank
BMCH	BMC Stock
BMI	Badger Meter
BMLP	Bank Of Montreal
BMRA	Biomerica
BMRC	Bank of Marin Bancorp
BMRN	BioMarin Pharmaceutical
BMS	Bemis Company
BMTC	Bryn Mawr Bank
BMY	Bristol-Myers Squibb
BNED	Barnes & Noble Education
BNFT	Benefitfocus
BNGO	Bionano Genomics
BNS	Bank of Nova Scotia
BNSO	Bonso Electronics International
BNTC	Benitec Biopharma Limited
BOCH	Bank of Commerce
BOH	Bank of Hawaii
BOKF	BOK Financial
BOLD	Audentes Therapeutics
BOMN	Boston Omaha
BOOM	DMC Global
BOOT	Boot Barn Holdings
BORN	China New Borun
BOSC	B.O.S. Better Online Solutions
BOTJ	Bank of the James Financial Group
BOX	Box, Inc.
BOXL	Boxlight
BP	BP
BPFH	Boston Private Financial
BPL	Buckeye Partners
BPMC	Blueprint Medicines
BPMP	BP Midstream Partners
BPMX	BioPharmX
BPOP	Popular, Inc.
BPR	Brookfield Property REIT
BPRN	The Bank of Princeton
BPT	BP Prudhoe Bay Royalty Trust
BPTH	Bio-Path Holdings
BPY	Brookfield Property Partners
BR	Broadridge Financial Solutions
BRAC	Black Ridge Acquisition
BRC	Brady Corporation
BREW	Craft Brew Alliance
BRFS	BRF
BRG	Bluerock Residential Growth REIT
BRID	Bridgford Foods
BRK.A	Berkshire Hathaway
BRKL	Brookline Bancorp
BRKR	Bruker
BRKS	Brooks Automation
BRN	Barnwell Industries
BRO	Brown & Brown
BROG	Twelve Seas Investment Company
BRPA	Big Rock Partners Acquisition
BRPM	B. Riley Principal Merger
BRQS	Borqs Technologies
BRSS	Global Brass and Copper Holdings
BRT	BRT Apartments
BRX	Brixmor Property Group
BRY	Berry Petroleum
BSA	BrightSphere Investment Group
BSAC	Banco Santander Chile
BSBR	Banco Santander Brasil
BSET	Bassett Furniture Industries
BSGM	BioSig Technologies
BSM	Black Stone Minerals
BSMX	Banco Santander Mexico
BSQR	BSQUARE
BSRR	Sierra Bancorp
BSTC	BioSpecifics Technologies
BSVN	Bank7
BSX	Boston Scientific
BT	BT Group
BTAI	BioXcel Therapeutics
BTE	Baytex Energy
BTG	B2Gold
BTI	British American Tobacco
BTN	Ballantyne Strong
BTU	Peabody Energy
BTX	BioTime
BUD	Anheuser-Busch Inbev
BURG	Chanticleer
BURL	Burlington Stores
BUSE	First Busey
BV	BrightView Holdings
BVN	Buenaventura Mining
BVNSC	Brandes Investment Trust
BVSN	BroadVision
BVXV	BiondVax Pharmaceuticals
BW	Babcock
BWA	BorgWarner
BWAY	Brainsway
BWB	Bridgewater Bancshares
BWEN	Broadwind Energy
BWFG	Bankwell Financial Group
BWG	BrandywineGLOBAL Globalome Opportunities Fund
BWL.A	Bowl America
BWMC	Boxwood Merger
BWXT	BWX Technologies
BX	Blackstone
BXC	BlueLinx
BXG	Bluegreen Vacations
BXMT	Capital Trust
BXP	Boston Properties
BXS	BancorpSouth Bank
BY	Byline Bancorp
BYD	Boyd Gaming
BYFC	Broadway Financial
BYND	Beyond Meat
BYSI	BeyondSpring
BZH	Beazer Homes USA
BZUN	Baozun
C	Citigroup
CAAP	Corporacion America Airports
CAAS	China Automotive Systems
CABO	Cable One
CAC	Camden National
CACC	Credit Acceptance
CACI	CACI International
CADC	China Advanced Construction Materials Group
CADE	Cadence Bancorporation
CAE	CAE
CAG	ConAgra Brands
CAH	Cardinal Health
CAI	CAI International
CAJ	Canon
CAKE	The Cheesecake Factoryorporated
CAL	Caleres
CALA	Calithera Biosciences
CALM	Cal-Maine Foods
CALX	Calix
CAMP	CalAmp
CAMT	Camtek
CANF	Can-Fite Biopharma
CANG	Cango
CAPL	CrossAmerica Partners
CAPR	Capricor Therapeutics
CAR	Avis Budget
CARA	Cara Therapeutics
CARB	Carbonite
CARE	Carter Bank & Trust
CARG	CarGurus
CARO	Carolina Financial
CARS	Cars.com
CART	Carolina Trust BancShares
CARV	Carver Bancorp
CASA	Casa Systems
CASH	Meta Financial Group
CASI	CASI Pharmaceuticals
CASS	Cass Information Systems
CASY	Caseys General Stores
CAT	Caterpillar
CATB	Catabasis Pharmaceuticals
CATC	Cambridge Bancorp
CATM	Cardtronics
CATO	Cato
CATS	Catasys
CATY	Cathay General Bancorp
CB	Chubb Limited
CBAN	Colony Bankcorp
CBAT	CBAK Energy Technology
CBAY	CymaBay Therapeutics
CBB	Cincinnati Bell
CBD	Companhia Brasileira de Distribuicao
CBFV	CB Financial Services
CBH	AllianzGI Convertible
CBIO	Catalyst Biosciences
CBL	CBL & Associates Properties
CBLI	Cleveland BioLabs
CBLK	Carbon Black
CBM	Cambrex
CBMB	CBM Bancorp
CBMG	Cellular Biomedicine Group
CBNK	Capital Bancorp
CBO	CBO
CBOE	Cboe Global Markets
CBPO	China Biologic Products
CBPX	Continental Building Products
CBRE	CBRE Group
CBRL	Cracker Barrel Old Country Store
CBS	CBS
CBSH	Commerce Bancshares
CBT	Cabot
CBTX	CBTX
CBU	Community Bank System
CBX	CBX
CBZ	CBIZ
CC	Chemours
CCA	MFS California Insured Municipal Trust
CCB	Coastal Financial
CCBG	Capital City Bank Group
CCC	Clarivate Analytics
CCCL	China Ceramics
CCEP	Coca-Cola European Partners
CCF	Chase
CCH	Collier Creek
CCI	Crown Castle International
CCIH	ChinaCache International
CCJ	Cameco
CCK	Crown Holdings
CCL	Carnival
CCLP	CSI Compressco
CCM	Concord Medical Services
CCMP	Cabot Microelectronics
CCNE	CNB Financial
CCNI	Command Center Inc
CCO	Clear Channel Outdoor
CCOI	Cogent Communications
CCR	CONSOL Coal Resources
CCRC	China Customer Relations Centers
CCRN	Cross Country Healthcare
CCS	Century Communities
CCU	Compania Cervecerias Unidas
CCXI	ChemoCentryx
CDAY	Ceridian HCM
CDE	Coeur Mining
CDEV	Centennial Resource Development
CDK	CDK Global
CDLX	Cardlytics
CDMO	Avid Bioservices
CDNA	CareDx
CDNS	Cadence Design Systems
CDOR	Condor Hospitality Trust
CDR	Cedar Realty Trust
CDTX	Cidara Therapeutics
CDW	CDW
CDXC	ChromaDex
CDXS	Codexis
CDZI	Cadiz
CE	Celanese
CEA	China Eastern Airlines
CECE	CECO Environmental
CECO	Career Education
CEE	The Central and Eastern Europe Fund
CEI	Camber Energy
CEL	Cellcom Israel
CELC	Celcuity
CELG	Celgene
CELH	Celsius Holdings
CELP	Cypress Energy Partners
CEM	ClearBridge MLP and Midstream Fund
CEMI	Chembio Diagnostics
CEN	Center Coast Brookfield MLP & Energy Infrastructur
CENT	Central Garden & Pet Company
CENX	Century Aluminum Company
CEO	CNOOC Limited
CEPU	Central Puerto
CEQP	Crestwood Equity Partners
CERC	Cerecor
CERN	Cerner
CERS	Cerus
CET	Central Securities
CETV	Central European Media Enterprises
CETX	Cemtrex
CEVA	CEVA
CF	CF Industries
CFBI	Community First Bancshares
CFBK	Central Federal
CFFA	CF Finance Acquisition
CFFI	C&F Financial
CFFN	Capitol Federal Financial
CFG	Citizens Financial Group
CFMS	ConforMIS
CFR	Cullen/Frost Bankers
CFRX	ContraFect
CFX	Colfax
CG	The Carlyle Group
CGA	China Green Agriculture
CGBD	TCG BDC
CGC	Canopy Growth
CGEN	Compugen
CGIX	Cancer Genetics
CGNX	Cognex
CHA	China Telecom
CHAC	Chardan Healthcare Acquisition
CHAP	Chaparral Energy
CHCI	Comstock Holding Companies
CHCO	City Holding Company
CHCT	Community Healthcare Trustorporated
CHD	Church & Dwight Company
CHDN	Churchill Downs
CHE	Chemed
CHEF	The Chefs' Warehouse
CHEK	Check-Cap
CHFC	Chemical Financial
CHFS	CHF Solutions
CHGG	Chegg
CHH	Choice Hotels International
CHK	Chesapeake Energy
CHKE	Cherokee
CHKP	Check Point Software Technologies
CHKR	Chesapeake Granite Wash Trust
CHL	China Mobile
CHMA	Chiasma
CHMG	Chemung Financial Corp
CHMI	Cherry Hill Mortgage Investment
CHN	China Fund
CHNR	China Natural Resources
CHRA	Charah Solutions
CHRS	Coherus BioSciences
CHRW	C.H. Robinson Worldwide
CHS	Chico's FAS
CHSCL	CHS
CHSP	Chesapeake Lodging Trust
CHT	Chunghwa Telecom
CHTR	Charter Communications
CHU	China Unicom
CHUY	Chuy's Holdings
CI	Cigna
CIA	Citizens
CIB	BanColombia
CIC	Capitol Investment
CIDM	Cinedigm
CIEN	Ciena
CIF	Colonial Intermediate Highome Fund
CIFS	China Internet Nationwide Financial Services
CIG	Comp En De Mn Cemig
CIGI	Colliers International Group
CIM	Chimera Investment
CINF	Cincinnati Financial
CINR	Ciner Resources
CIO	City Office REIT
CIR	CIRCOR International
CISN	Cision
CIT	CIT Group
CIVB	Civista Bancshares
CIX	CompX International
CIZN	Citizens Holding Company
CJ	C&J Energy Services
CJJD	China Jo-Jo Drugstores
CKH	SEACOR Holdings
CKPT	Checkpoint Therapeutics
CKX	CKX Lands
CL	Colgate-Palmolive Company
CLAR	Clarus
CLB	Core Laboratories
CLBK	Columbia Financial
CLBS	Caladrius Biosciences
CLCT	Collectors Universe
CLDB	Cortland Bancorp
CLDC	China Lending
CLDR	Cloudera
CLDT	Chatham Lodging Trust
CLDX	Celldex Therapeutics
CLF	Cleveland-Cliffs
CLFD	Clearfield
CLGN	CollPlant Holdings
CLGX	CoreLogic
CLH	Clean Harbors
CLI	Mack-Cali Realty
CLIR	ClearSign Combustion
CLLS	Cellectis
CLM	Cornerstone Strategic Value Fund
CLMT	Calumet Specialty Products Partners
CLNC	Colony Credit Real Estate
CLNE	Clean Energy Fuels
CLNY	Colony Capital
CLPR	Clipper Realty
CLPS	CLPSorporation
CLR	Continental Resources
CLRB	Cellectar Biosciences
CLRO	ClearOne
CLS	Celestica
CLSD	Clearside Biomedical
CLSN	Celsion
CLUB	Town Sports International Holdings
CLVS	Clovis Oncology
CLW	Clearwater Paper
CLWT	Euro Tech Holdings
CLX	Clorox
CLXT	Calyxt
CM	Canadian Imperial Bank of Commerce
CMA	Comerica
CMC	Commercial Metals Company
CMCL	Caledonia Mining
CMCM	Cheetah Mobile
CMCO	Columbus McKinnon
CMCSA	Comcast
CMCT	CIM Commercial Trust
CMD	Cantel Medical
CME	CME Group
CMFN	CM Finance
CMG	Chipotle
CMI	Cummins
CMLS	Cumulus Media
CMO	Capstead Mortgage
CMP	Compass Minerals International
CMPR	Cimpress
CMRE	Costamare
CMRX	Chimerix
CMS	CMS Energy
CMT	Core Molding Technologies
CMTL	Comtech Telecommunications
CMU	Colonial Municipalome Trust
CNA	CNA Financial
CNAC	Constellation Alpha Capital
CNAT	Conatus Pharmaceuticals
CNBKA	Century Bancorp
CNC	Centene
CNCE	Concert Pharmaceuticals
CNDT	Conduentorporated
CNET	ChinaNet Online Holdings
CNF	CNFinance Holdings Limited
CNFR	Conifer Holdings
CNHI	CNH Industrial
CNI	Canadian National Railway
CNK	Cinemark
CNMD	CONMED
CNNE	Cannae
CNO	CNO Financial Group
CNOB	ConnectOne Bancorp
CNP	CenterPoint Energy
CNQ	Canadian Natural Resources Limited
CNR	Cornerstone Building Brands
CNS	Cohen & Steers
CNSL	Consolidated Communications Holdings
CNST	Constellation Pharmaceuticals
CNTF	China TechFaith Wireless Communication Technology Limited
CNTY	Century Casinos
CNX	CNX Resources
CNXM	CNX Midstream Partners
CNXN	PC Connection
CO	Global Cord Blood
COCP	Cocrystal Pharma
CODA	Coda Octopus Group
CODI	Compass Diversified Holdings
CODX	Co-Diagnostics
COE	China Online Education Group
COF	Capital One Financial
COG	Cabot Oil & Gas
COHN	Cohen & Company
COHR	Coherent
COHU	Cohu
COKE	Coca-Cola Consolidated
COLB	Columbia Banking System
COLD	Americold Realty Trust
COLL	Collegium Pharmaceutical
COLM	Columbia Sportswear
COMM	CommScope
CONE	CyrusOne
CONN	Conn's
COO	The Cooper Companies
COOP	Mr. Cooper Group
COP	ConocoPhillips
COR	CoreSite Realty
CORE	Core-Mark Holding
CORR	CorEnergy Infrastructure Trust
CORT	Corcept Therapeutics
CORV	Correvio Pharma
COST	Costco
COT	Cott
COTY	Coty
COUP	Coupa Software
COWN	Cowen
CP	Canadian Pacific Railway
CPA	Copa Holdings
CPAC	Cementos Pacasmayo
CPAH	CounterPath
CPB	Campbell Soup
CPE	Callon Petroleum
CPF	CPB
CPG	Crescent Point Energy
CPHC	Canterbury Park Holding
CPHI	China Pharma Holdings
CPIX	Cumberland Pharmaceuticals
CPK	Chesapeake Utilities
CPL	CPFL Energia
CPLG	CorePoint Lodging
CPLP	Capital Product Partners
CPRI	Capri Holdings Limited
CPRT	Copart
CPRX	Catalyst Pharmaceuticals
CPS	Cooper-Standard Holdings
CPSH	CPS Technologies
CPSI	Computer Programs and Systems
CPSS	Consumer Portfolio Services
CPST	Capstone Turbine
CPT	Camden Property Trust
CPTA	Capitala Finance
CQP	Cheniere Energy Partners
CR	Crane Co.
CRAI	CRA International
CRAY	Cray
CRBP	Corbus Pharmaceuticals Holdings
CRC	California Resources
CRCM	Care.com
CRD.A	Crawford & Company
CREE	Cree
CREG	China Recycling Energy
CRESY	Cresud
CREX	Creative Realities
CRF	Cornerstone Strategic Return Fund
CRH	CRH
CRHM	CRH Medical
CRI	Carter's
CRIS	Curis
CRK	Comstock Resources
CRL	Charles River Laboratories
CRM	Salesforce
CRM	Salesforce.com
CRMD	CorMedix
CRMT	America's Car-Mart
CRNT	Ceragon Networks
CRNX	Crinetics Pharmaceuticals
CRON	Cronos Group
CROX	Crocs
CRR	Carbo Ceramics
CRS	Carpenter Technology
CRSA	Crescent Acquisition
CRSP	CRISPR Therapeutics
CRT	Cross Timbers Royalty Trust
CRTO	Criteo
CRTX	Cortexyme
CRUS	Cirrus Logic
CRUSC	Calvert Management Series
CRVL	CorVel
CRVS	Corvus Pharmaceuticals
CRWS	Crown Crafts
CRY	CryoLife
CRZO	Carrizo Oil & Gas
CS	Credit Suisse Group
CSBR	Champions Oncology
CSCO	Cisco
CSFL	CenterState Bank
CSGP	CoStar Group
CSGS	CSG Systems International
CSII	Cardiovascular
CSIQ	Canadian Solar
CSL	Carlisle Companies
CSLT	Castlight Health
CSOD	Cornerstone OnDemand
CSPI	CSP
CSS	CSS Industries
CSSE	Chicken Soup for the Soul Entertainment
CSTE	Caesarstone
CSTM	Constellium
CSTR	CapStar Financial Holdings
CSU	Capital Senior Living
CSV	Carriage Services
CSWC	Capital Southwest
CSWI	CSW Industrials
CSX	CSX
CTAA	Qwest
CTAC	ChaSerg Technology Acquisition
CTAS	Cintas
CTB	Cooper Tire & Rubber
CTBI	Community Trust Bancorp
CTEK	CynergisTek
CTG	Computer Task Group
CTHR	Charles & Colvard
CTIB	CTI Industries
CTIC	CTI BioPharma
CTK	CooTek
CTL	CenturyLink
CTLT	Catalent
CTMX	CytomX Therapeutics
CTO	Consolidated-Tomoka Land
CTR	ClearBridge MLP and Midstream Total Return Fund In
CTRA	Contura Energy
CTRC	Centric Brands
CTRE	CareTrust REIT
CTRL	Control4
CTRM	Castor Maritime
CTRN	Citi Trends
CTRP	Ctrip.com International
CTRV	ContraVir Pharmaceuticals
CTS	CTS Corporation
CTSH	Cognizant Technology Solutions
CTSO	Cytosorbents
CTST	CannTrust Holdings
CTT	CatchMark Timber Trust
CTVA$	Corteva
CTWS	Connecticut Water Service
CTXR	Citius Pharmaceuticals
CTXS	Citrix Systems
CUB	Cubic
CUBA	The Herzfeld Caribbean Basin Fund
CUBE	CubeSmart
CUBI	Customers Bancorp
CUE	Cue Biopharma
CUI	CUI Global
CULP	Culp
CUO	Continental Materials
CUR	Neuralstem
CURO	CURO Group Holdings
CUTR	Cutera
CUZ	Cousins Properties
CVA	Covanta Holding
CVBF	CVB Financial
CVCO	Cavco Industries
CVCY	Central Valley Community Bancorp
CVE	Cenovus Energy
CVEO	Civeo
CVET	Covetrus
CVGI	Commercial Vehicle Group
CVGW	Calavo Growers
CVI	CVR Energy
CVIA	Covia Holdings
CVLT	Commvault Systems
CVLY	Codorus Valley Bancorp
CVM	Cel-Sci
CVNA	Carvana
CVR	Chicago Rivet & Machine
CVRS	Corindus Vascular Robotics
CVS	CVS
CVTI	Covenant Transportation Group
CVU	CPI Aerostructures
CVV	CVD Equipment
CVX	Chevron
CW	Curtiss-Wright
CWBC	Community West Bancshares
CWBR	CohBar
CWCO	Consolidated Water
CWEN	Clearway Energy
CWH	Camping World Holdings
CWK	Cushman & Wakefield
CWST	Casella Waste Systems
CWT	California Water Service Group Holding
CX	Cemex
CXDC	China XD Plastics
CXE	Colonial Highome Municipal Trust
CXH	Colonial Investment Grade Municipal Trust
CXO	Concho Resources
CXP	Columbia Property Trust
CXW	CoreCivic
CY	Cypress Semiconductor
CYAD	Celyad
CYAN	Cyanotech
CYBE	CyberOptics
CYBR	CyberArk Software
CYCC	Cyclacel Pharmaceuticals
CYCN	Cyclerion Therapeutics
CYD	China Yuchai International Limited
CYH	Community Health Systems
CYOU	Changyou
CYOU	Changyou.com
CYRN	CYREN
CYRX	CryoPort
CYTK	Cytokinetics
CYTR	CytRx
CYTX	Cytori Therapeutics
CZFC	Citizens First
CZNC	Citizens & Northern Corp
CZR	Caesars Entertainment
CZWI	Citizens Community Bancorp
CZZ	Cosan Limited
D	Dominion Energy
DAC	Danaos
DAIO	Data I/O Corporation
DAKT	Daktronics
DAL	Delta Air Lines
DAN	Dana Incorporated
DAR	Darling Ingredients
DARE	Dare Bioscience
DATA	Tableau
DAVA	Endava
DAVE	Famous Dave's of America
DB	Deutsche Bank
DBD	Diebold Nixdorf
DBI	Designer Brands
DBL	DoubleLine Opportunistic Credit Fund
DBVT	DBV Technologies
DBX	Dropbox
DCAR	DropCar
DCF	Dreyfus Alcentra
DCI	Donaldson Company
DCIX	Performance Shipping
DCO	Ducommun
DCOM	Dime Community Bancshares
DCP	DCP Midstream
DCPH	Deciphera Pharmaceuticals
DD	E.I. du Pont de Nemours and Company
DDD	3D Systems
DDF	Delaware Investments Dividend & Income Fund
DDMX	DD3 Acquisition
DDS	Dillard's
DE	Deere & Company
DEA	Easterly Government Properties
DEACU	Diamond Eagle Acquisition
DECK	Deckers Outdoor
DEI	Douglas Emmett
DELL	Dell
DENN	Denny's Corporation
DEO	Diageo
DERM	Dermira
DESP	Despegar.com
DEST	Destination Maternity
DEX	Delaware Enhanced Global Dividend
DF	Dean Foods Company
DFBH	DFB Healthcare Acquisitions
DFFN	Diffusion Pharmaceuticals
DFIN	Donnelley Financial Solutions
DFRG	Del Frisco's Restaurant Group
DFS	Discover Financial Services
DG	Dollar General
DGICA	Donegal Group
DGII	Digi International
DGLY	Digital Ally
DGSE	DGSE Companies
DGX	Quest Diagnostics
DHI	D.R. Horton
DHIL	Diamond Hill Investment Group
DHR	Danaher
DHT	DHT Holdings
DHX	DHI Group
DHXM	DHX Media
DIN	Dine Brands Global
DIOD	Diodes
DIS	Walt Disney
DISCA	Discovery Inc
DISH	DISH Network
DIT	AMCON Distributing Company
DJCO	Daily Journal
DK	Delek US Holdings
DKL	Delek Logistics Partners
DKS	Dick's Sporting Goods
DKT	Deutsch Bk Contingent Cap Tr V
DL	China Distance Education Holdings Limited
DLA	Delta Apparel
DLB	Dolby Laboratories
DLHC	DLH Holdings
DLNG	Dynagas LNG Partners
DLPH	Delphi Technologies
DLPN	Dolphin Entertainment
DLR	Digital Realty Trust
DLTH	Duluth Holdings
DLTR	Dollar Tree
DLX	Deluxe
DMAC	DiaMedica Therapeutics
DMLP	Dorchester Minerals
DMPI	DelMar Pharmaceuticals
DMRC	Digimarc
DNBF	DNB Financial Corp
DNI	Dividend andome Fund
DNJR	GOLDEN BULL LIMITED
DNKN	Dunkin' Brands Group
DNLI	Denali Therapeutics
DNN	Denison Mine Corp
DNP	Duff & Phelps Utilitiesome
DNR	Denbury Resources
DO	Diamond Offshore Drilling
DOC	Physicians Realty Trust
DOCU	DocuSign
DOGZ	Dogness
DOMO	Domo
DOOO	BRP
DOOR	Masonite International
DORM	Dorman Products
DOV	Dover
DOVA	Dova Pharmaceuticals
DOW	Dow
DOX	Amdocs Limited
DPHC	DiamondPeak Holdings
DPLO	Diplomat Pharmacy
DPW	DPW Holdings
DPZ	Domino's Pizza
DQ	DAQO New Energy
DRAD	Digirad
DRD	DRDGOLD Limited
DRH	Diamondrock Hospitality Company
DRI	Darden Restaurants
DRIO	DarioHealth
DRNA	Dicerna Pharmaceuticals
DRQ	Dril-Quip
DRRX	DURECT
DRYS	DryShips
DS	Drive Shack
DSGX	The Descartes Systems Group
DSKE	Daseke
DSL	DoubleLineome Solutions Fund
DSPG	DSP Group
DSS	Document Security Systems
DSSI	Diamond S Shipping
DSWL	Deswell Industries
DSX	Diana Shipping
DTE	DTE Energy Company
DTEA	DAVIDsTEA
DTIL	Precision BioSciences
DTLA	Brookfield DTLA
DTSS	Datasea
DUK	Duke Energy
DVA	DaVita
DVAX	Dynavax Technologies
DVCR	Diversicare Healthcare Services
DVD	Dover Motorsports
DVN	Devon Energy
DWAT	Arrow DWA Tactical ETF
DWCR	Arrow DWA Country Rotation ETF
DWDP	DowDuPont
DWMC	AdvisorShares Dorsey Wright Micro-Cap ETF
DWSH	AdvisorShares Dorsey Wright Short ETF
DWSN	Dawson Geophysical
DX	Dynex Capital
DXC	DXC Technology
DXCM	DexCom
DXF	Dunxin Financial Holdings Limited
DXLG	Destination XL Group
DXPE	DXP Enterprises
DXR	Daxor
DXYN	The Dixie Group
DY	Dycom Industries
DYAI	Dyadic International
DYNT	Dynatronics
DYSL	Dynasil of America
DZSI	DASAN Zhone Solutions
E	ENI S.p.A.
EA	Electronic Arts
EAF	GrafTech International
EARN	Ellington Residential Mortgage REIT
EARS	Auris Medical Holding
EAST	Eastside Distilling
EAT	Brinker International
EB	Eventbrite
EBAY	eBay
EBF	Ennis
EBIX	Ebix
EBMT	Eagle Bancorp Montana
EBR	Centrais Electricas Brasileiras
EBS	Emergent Biosolutions
EBSB	Meridian Bancorp
EBTC	Enterprise Bancorp
EC	Ecopetrol
ECA	Encana
ECC	Eagle Point Credit Company
ECF	Ellsworth Growth andome Fund
ECHO	Echo Global Logistics
ECL	Ecolab
ECOL	US Ecology
ECOM	ChannelAdvisor
ECOR	electroCore
ECPG	Encore Capital Group
ECT	ECA Marcellus Trust
ED	Consolidated Edison
EDAP	EDAP TMS
EDF	Stone Harbor Emerging Marketsome Fund
EDI	Stone Harbor Emerging Markets Totalome Fund
EDIT	Editas Medicine
EDN	Empresa Distribuidora Y Comercializadora Norte
EDNT	Edison Nation
EDRY	EuroDry
EDTX	EdtechX Holdings Acquisition
EDU	New Oriental Education & Technology Group
EDUC	Educational Development
EE	El Paso Electric
EEA	European Equity Fund
EEFT	Euronet Worldwide
EEI	Ecology and Environment
EEX	Emerald Expositions Events
EFBI	Eagle Financial Bancorp
EFC	Ellington Financial
EFII	Electronics for Imaging
EFOI	Energy Focus
EFSC	Enterprise Financial Services
EFX	Equifax
EGAN	eGain
EGBN	Eagle Bancorp
EGHT	8x8 Inc
EGI	Entree Resources
EGIF	Eagle Growth andome Opportunities Fund
EGLE	Eagle Bulk Shipping
EGO	Eldorado Gold
EGOV	NIC
EGP	EastGroup Properties
EGRX	Eagle Pharmaceuticals
EGY	VAALCO Energy
EHC	Encompass Health
EHTH	eHealth
EIDX	Eidos Therapeutics
EIG	Employers Holdings
EIGI	Endurance International Group Holdings
EIGR	Eiger BioPharmaceuticals
EIX	Edison International
EKSO	Ekso Bionics Holdings
EL	Estee Lauder Companies
ELAN	Elanco Animal Health
ELF	e.l.f. Beauty
ELGX	Endologix
ELLO	Ellomay Capital
ELMD	Electromed
ELOX	Eloxx Pharmaceuticals
ELP	Companhia Paranaense de Energia
ELS	Equity Lifestyle Properties
ELSE	Electro-Sensors
ELTK	Eltek
ELVT	Elevate Credit
ELY	Callaway Golf
EMAN	eMagin
EMCF	Emclaire Financial Corp
EMCI	EMC Insurance Group
EME	EMCOR Group
EMES	Emerge Energy Services
EMF	Templeton Emerging Markets Fund
EMKR	EMCORE
EML	Eastern Company
EMMS	Emmis Communications
EMN	Eastman Chemical Company
EMO	ClearBridge Energy Midstream Opportunity Fund
EMR	Emerson Electric
EMX	EMX Royalty
ENB	Enbridge
ENBL	Enable Midstream Partners
ENDP	Endo International
ENFC	Entegra Financial
ENG	ENGlobal
ENIA	Enel Americas
ENIC	Enel Chile
ENLC	EnLink Midstream
ENLV	Enlivex Therapeutics
ENOB	Enochian Biosciences
ENPH	Enphase Energy
ENR	Energizer Holdings
ENS	Enersys
ENSG	The Ensign Group
ENSV	ENSERVCO
ENT	Global Eagle Entertainment
ENTA	Enanta Pharmaceuticals
ENTG	Entegris
ENTX	Entera Bio
ENV	Envestnet
ENVA	Enova International
ENZ	Enzo Biochem
EOG	EOG Resources
EOLS	Evolus
EP	El Paso Corporation
EPAM	EPAM Systems
EPAY	Bottomline Technologies
EPD	Enterprise Products Partners
EPIX	ESSA Pharma
EPM	Evolution Petroleum
EPR	EPR Properties
EPRT	Essential Properties Realty Trust
EPSN	Epsilon Energy
EPZM	Epizyme
EQ	Equillium
EQBK	Equity Bancshares
EQC	Equity Commonwealth
EQH	AXA Equitable
EQIX	Equinix
EQM	EQM Midstream Partners
EQNR	Equinor
EQR	Equity Residential
EQS	Equus Total Return
EQT	EQT
ERA	Era Group
ERF	Enerplus
ERI	Eldorado Resorts
ERIC	Ericsson
ERIE	Erie Indemnity Company
ERII	Energy Recovery
ERJ	Embraer
EROS	Eros International
ERYP	Erytech Pharma
ES	Eversource Energy
ESBK	Elmira Savings Bank NY
ESCA	Escalade
ESE	ESCO Technologies
ESEA	Euroseas
ESGR	Enstar Group Limited
ESI	Element Solutions
ESLT	Elbit Systems
ESNT	Essent Group
ESP	Espey Mfg. & Electronics
ESPR	Esperion Therapeutics
ESQ	Esquire Financial Holdings
ESRT	Empire State Realty Trust
ESS	Essex Property Trust
ESSA	ESSA Bancorp
ESTA	Establishment Labs Holdings
ESTC	Elastic
ESTE	Earthstone Energy
ESTR	Estre Ambiental
ESV	Ensco Rowan
ESXB	Community Bankers Trust
ET	Energy Transfer
ETFC	E*TRADE
ETH	Ethan Allen Interiors
ETM	Entercom Communications
ETN	Eaton Corporation
ETON	Eton Pharmaceuticals
ETP	Energy Transfer Operating
ETR	Entergy
ETRN	Equitrans Midstream
ETSY	Etsy
ETTX	Entasis Therapeutics Holdings
ETV	Eaton Vance
EURN	Euronav
EVA	Enviva Partners
EVBG	Everbridge
EVBN	Evans Bancorp
EVC	Entravision Communications
EVER	EverQuote
EVFM	Evofem Biosciences
EVGN	Evogene
EVH	Evolent Health
EVI	EVI Industries
EVK	Ever-Glory International Group
EVLO	Evelo Biosciences
EVLV	EVINE Live
EVOK	Evoke Pharma
EVOL	Evolving Systems
EVOP	EVO Payments
EVR	Evercore
EVRG	Evergy
EVRI	Everi Holdings
EVSI	Envision Solar International
EVTC	Evertec
EW	Edwards Lifesciences
EWBC	East West Bancorp
EXAS	Exact Sciences
EXC	Exelon
EXEL	Exelixis
EXFO	EXFO
EXK	Endeavour Silver
EXLS	ExlService Holdings
EXP	Eagle Materials
EXPD	Expeditors International of Washington
EXPE	Expedia
EXPI	eXp World Holdings
EXPO	Exponent
EXPR	Express, Inc.
EXR	Extra Space Storage
EXTN	Exterran
EXTR	Extreme Networks
EYEG	Eyegate Pharmaceuticals
EYEN	Eyenovia
EYES	Second Sight Medical Products
EYPT	EyePoint Pharmaceuticals
EZPW	EZCORP
F	Ford
FAF	First American
FAMI	FARMMI
FANG	Diamondback Energy
FANH	Fanhua
FARM	Farmer Brothers
FARO	FARO Technologies
FAST	Fastenal
FAT	FAT Brands Inc.
FATE	Fate Therapeutics
FAX	Aberdeen Asia-Pacificome Fund
FB	Facebook
FBC	Flagstar Bancorp
FBHS	Fortune Brands Home & Security
FBIO	Fortress Biotech
FBIZ	First Business Financial Services
FBK	FB Financial
FBM	Foundation Building Materials
FBMS	The First Bancshares
FBP	First BanCorp
FBSS	Fauquier Bankshares
FC	Franklin Covey
FCAP	First Capital
FCAU	Fiat Chrysler Automobiles
FCBC	First Community Bankshares
FCBP	First Choice Bancorp
FCCO	First Community
FCCY	1st Constitution Bancorp
FCEL	FuelCell Energy
FCF	First Commonwealth Financial
FCFS	FirstCash
FCN	FTI Consulting
FCNCA	First Citizens BancShares
FCO	Aberdeen Globalome Fund
FCPT	Four Corners Property Trust
FCSC	Fibrocell Science
FCX	Freeport-McMoran
FDBC	Fidelity D & D Bancorp
FDC	First Data
FDEF	First Defiance Financial
FDP	Fresh Del Monte Produce
FDS	FactSet Research
FDUS	Fidus Investment
FDX	FedEx
FE	FirstEnergy
FEDU	Four Seasons Education
FEIM	Frequency Electronics
FELE	Franklin Electric
FELP	Foresight Energy
FENC	Fennec Pharmaceuticals
FENG	Phoenix New Media Limited
FET	Forum Energy Technologies
FEYE	FireEye
FF	FutureFuel
FFA	First Trust
FFBC	First Financial Bancorp.
FFBW	FFBW
FFG	FBL Financial Group
FFHL	Fuwei Films
FFIC	Flushing Financial
FFIN	First Financial Bankshares
FFIV	F5 Networks
FFNW	First Financial Northwest
FFWM	First Foundation
FG	FGL Holdings
FGBI	First Guaranty Bancshares
FGEN	FibroGen
FGP	Ferrellgas Partners
FHB	First Hawaiian
FHL	Futu Holdings Limited
FHN	First Horizon National
FI	Frank's International
FIBK	First Interstate BancSystem
FICO	Fair Isaac
FII	Federated Investors
FIS	Fidelity National Information Services
FISI	Financial Institutions
FISV	Fiserv
FIT	Fitbit
FITB	Fifth Third Bancorp
FIVE	Five Below
FIVN	Five9
FIX	Comfort Systems USA
FIXX	Homology Medicines
FL	Foot Locker
FLAG	Exchange Traded Concepts Trust FLAG
FLDM	Fluidigm
FLEX	Flex Ltd.
FLGT	Fulgent Genetics
FLIC	The First of Long Island
FLIR	FLIR Systems
FLKS	Flex Pharma
FLL	Full House Resorts
FLMN	Falcon Minerals
FLNT	Fluent
FLO	Flowers Foods
FLOW	SPX FLOW
FLR	Fluor
FLS	Flowserve
FLT	FleetCor Technologies
FLWS	1-800 FLOWERS.COM
FLXN	Flexion Therapeutics
FLXS	Flexsteel Industries
FLY	Fly Leasing Limited
FMAO	Farmers & Merchants Bancorp
FMBH	First Mid Bancshares
FMBI	First Midwest Bancorp
FMC	FMC
FMCI	Forum Merger
FMN	Federated Premier Municipalome Fund
FMNB	Farmers National Banc
FMO	Fiduciary/Claymore Energy Infrastructure Fund
FMS	Fresenius Medical Care
FMX	Fomento Economico Mexicano
FN	Fabrinet
FNB	F.N.B.
FNCB	FNCB Bancorp
FND	Floor & Decor Holdings
FNF	Fidelity National Financial
FNHC	FedNat Holding
FNJN	Finjan Holdings
FNKO	Funko
FNSR	Finisar
FNV	Franco-Nevada
FNWB	First Northwest Bancorp
FOCS	Focus Financial Partners
FOE	Ferro
FOLD	Amicus Therapeutics
FOMX	Foamix Pharmaceuticals
FONR	Fonar
FOR	Forestar Group
FORD	Forward Industries
FORK	Fuling Global
FORM	FormFactor
FORR	Forrester Research
FORTY	Formula Systems (1985)
FOSL	Fossil Group
FOX	Fox
FOXF	Fox Factory Holding
FPAC	Far Point Acquisition
FPAY	FlexShopper
FPH	Five Point Holdings
FPI	Farmland Partners
FPRX	Five Prime Therapeutics
FR	First Industrial Realty Trust
FRAC	Keane Group
FRAF	Franklin Financial Services
FRAN	Francesca's Holdings
FRBA	First Bank
FRBK	Republic First Bancorp
FRC	FIRST REPUBLIC BANK
FRD	Friedman Industries
FRED	Fred's, Inc.
FRGI	Fiesta Restaurant Group
FRME	First Merchants
FRO	Frontline
FRPH	FRP Holdings
FRPT	Freshpet
FRSX	Foresight Autonomous Holdings
FRT	Federal Realty Investment Trust
FRTA	Forterra
FSB	Franklin Financial Network
FSBC	FSB Bancorp
FSBW	FS Bancorp
FSCT	ForeScout Technologies
FSFG	First Savings Financial Group
FSI	Flexible Solutions International
FSK	FS KKR Capital
FSLR	First Solar
FSLY	Fastly
FSM	Fortuna Silver Mines
FSP	Franklin Street Properties
FSS	Federal Signal
FSTR	L.B. Foster Company
FSV	FirstService
FT	Franklin Universal Trust
FTAC	FinTech Acquisition
FTAI	Fortress Transportation and Infrastructure Investors
FTCH	Farfetch Limited
FTD	FTD Companies
FTDR	frontdoor, inc.
FTEK	Fuel Tech
FTEO	FRONTEO
FTF	Franklin Limited Durationome Trust
FTFT	Future FinTech Group
FTI	TechnipFMC
FTK	Flotek Industries
FTNT	Fortinet
FTNW	FTE Networks
FTR	Frontier Communications
FTS	Fortis
FTSI	FTS International
FTSV	Forty Seven
FTV	Fortive
FUL	H. B. Fuller Company
FULT	Fulton Financial
FUN	Cedar Fair
FUNC	First United
FUND	Sprott Focus Trust
FUSB	First US Bancshares
FUV	Arcimoto
FVCB	FVCBankcorp
FVE	Five Star Senior Living
FWP	Forward Pharma
FWRD	Forward Air Corporation
FXNC	First National Corporation
G	Genpact
GABC	German American Bancorp
GAIA	Gaia
GALT	Galectin Therapeutics
GAM	General American Investors
GARS	Garrison Capital
GASS	StealthGas
GATX	GATX
GBAB	Guggenheim Taxable Municipal Managed Duration Trst
GBCI	Glacier Bancorp
GBDC	Golub Capital BDC
GBL	Gabelli
GBL	Gamco Investors
GBLI	Global Indemnity Limited
GBR	New Concept Energy
GBT	Global Blood Therapeutics
GBX	Greenbrier Companies
GCAP	GAIN Capital Holdings
GCBC	Greene County Bancorp
GCI	TEGNA
GCO	Genesco
GCP	GCP Applied Technologies
GD	General Dynamics
GDDY	GoDaddy
GDEN	Golden Entertainment
GDI	Gardner Denver Holdings
GDL	The GDL Fund
GDOT	Green Dot
GDP	Goodrich Petroleum
GDS	GDS Holdings Limited
GE	General Electric
GEC	Great Elm Capital Group
GECC	Great Elm Capital
GEF	Greif Bros.
GEL	Genesis Energy
GEMP	Gemphire Therapeutics
GEN	Genesis Healthcare
GENC	Gencor Industries
GENE	Genetic Technologies Ltd
GEO	Geo Group
GEOS	Geospace Technologies
GERN	Geron
GES	Guess Inc
GEVO	Gevo
GF	New Germany Fund
GFED	Guaranty Federal Bancshares
GFF	Griffon
GFI	Gold Fields Limited
GFN	General Finance
GGAL	Grupo Financiero Galicia
GGB	Gerdau
GGG	Graco
GGM	Guggenheim Credit Allocation Fund
GGN	GAMCO Global Gold, Natural Reources & Inome Trust
GGO	The Gabelli Go Anywhere Trust
GH	Guardant Health
GHC	Graham Holdings
GHDX	Genomic Health
GHG	GreenTree Hospitality Group
GHL	Greenhill & Co.
GHM	Graham
GHSI	Guardion Health Sciences
GIB	CGI
GIFI	Gulf Island Fabrication
GIG	GigCapital
GIGE	SoFi Gig Economy ETF
GIGM	GigaMedia Limited
GIII	G-III Apparel Group
GIL	Gildan Activewear
GILD	Gilead Sciences
GILT	Gilat Satellite Networks
GIM	Templeton Globalome Fund
GIS	General Mills
GJH	STRATS Trust
GJP	Synthetic Fixed-Income Securities
GKOS	Glaukos
GLAC	Greenland Acquisition
GLAD	Gladstone Capital
GLBS	Globus Maritime Limited
GLBZ	Glen Burnie Bancorp
GLDD	Great Lakes Dredge & Dock
GLG	China Bat Group
GLIBA	GCI Liberty
GLMD	Galmed Pharmaceuticals
GLNG	Golar LNG
GLO	Clough Global Opportunities Fund
GLOB	Globant
GLOG	GasLog.
GLOG	GasLog Partners
GLOW	Glowpoint
GLP	Global Partners
GLPG	Galapagos
GLPI	Gaming and Leisure Properties
GLQ	Clough Global Equity Fund
GLRE	Greenlight Reinsurance
GLT	Glatfelter
GLU	The Gabelli Global Utility andome Trust
GLUU	Glu Mobile
GLV	Clough Global Dividend andome Fund
GLW	Corningorporated
GLYC	GlycoMimetics
GM	General Motors
GMDA	Gamida Cell
GME	Gamestop
GMED	Globus Medical
GMHI	Gores Metropoulos
GMLP	Golar LNG Partners
GMO	General Moly
GMRE	Global Medical REIT
GMS	GMS
GNC	GNC Holdings
GNCA	Genocea Biosciences
GNE	Genie Energy
GNFT	GENFIT
GNK	Genco Shipping & Trading Limited
GNL	Global Net Lease
GNLN	Greenlane Holdings
GNMK	GenMark Diagnostics
GNMX	Aevi Genomic Medicine
GNPX	Genprex
GNRC	Generac Holdlings
GNT	GAMCO Natural Resources, Gold & Income Tust
GNTX	Gentex
GNTY	Guaranty Bancshares
GNUS	Genius Brands International
GNW	Genworth Financial
GOF	Guggenheim Strategic Opportunities Fund
GOGL	Golden Ocean Group Limited
GOGO	Gogo
GOL	Gol Linhas Aereas Inteligentes
GOLD	Barrick Gold
GOLF	Acushnet
GOOD	Gladstone Commercial
GOOG	Alphabet Inc.
GOOG	Google
GOOS	Canada Goose Holdings
GORO	Gold Resource
GOSS	Gossamer Bio
GPAQ	Gordon Pointe Acquisition
GPC	Genuine Parts Company
GPI	Group 1 Automotive
GPJA	Georgia Power Company
GPK	Graphic Packaging Holding Company
GPL	Great Panther Mining Limited
GPM	Guggenheim Enhanced Equityome Fund
GPMT	Granite Point Mortgage Trust
GPN	Global Payments Inc.
GPOR	Gulfport Energy
GPP	Green Plains Partners
GPRE	Green Plains
GPRK	Geopark
GPRO	GoPro
GPS	Gap, Inc
GPX	GP Strategies
GRA	W.R. Grace & Co.
GRAF	Graf Industrial
GRAM	Grana y Montero
GRBK	Green Brick Partners
GRC	Gorman-Rupp Company
GRF	Eagle Capital Growth Fund
GRFS	Grifols
GRIF	Griffin Industrial Realty
GRIN	Grindrod Shipping Holdings
GRMN	Garmin
GRNQ	Greenpro Capital
GROW	U.S. Global Investors, Inc.
GRP.U	Granite Real Estate
GRPN	Groupon
GRSH	Gores Holdings
GRTS	Gritstone Oncology
GRUB	GrubHub
GRVY	GRAVITY Co.
GRX	The Gabelli Healthcare & Wellness Trust
GS	Goldman Sachs
GSAH	GS Acquisition Holdings
GSAT	Globalstar
GSB	GlobalSCAPE
GSBC	Great Southern Bancorp
GSH	Guangshen Railway
GSHD	Goosehead Insurance
GSIT	GSI Technology
GSK	GlaxoSmithKline
GSKY	GreenSky
GSL	Global Ship Lease
GSM	Ferroglobe
GSS	Golden Star Resources
GSUM	Gridsum Holding
GSV	Gold Standard Ventures
GSVC	GSV Capital
GT	The Goodyear Tire & Rubber Company
GTE	Gran Tierra Energy
GTES	Gates Industrial
GTHX	G1 Therapeutics
GTIM	Good Times Restaurants
GTLS	Chart Industries
GTN	Gray Television
GTS	Triple-S Management
GTT	GTT Communications
GTX	Garrett Motion
GTXI	GTx
GTY	Getty Realty
GTYH	GTY Technology Holdings
GURE	Gulf Resources
GV	Goldfield Corporation
GVA	Granite Constructionorporated
GVP	GSE Systems
GWB	Great Western Bancorp
GWGH	GWG Holdings
GWPH	GW Pharmaceuticals
GWR	Genesee & Wyoming
GWRE	Guidewire Software
GWRS	Global Water Resources
GWW	W.W. Grainger
GXGXU	GX Acquisiton
GYB	CABCO Series 2004-101 Trust
GYC	Corporate Asset Backed Corp CABCO
GYRO	Gyrodyne
H	Hyatt
HA	Hawaiian Holdings
HABT	The Habit Restaurants
HAE	Haemonetics
HAFC	Hanmi Financial
HAIN	The Hain Celestial
HAIR	Restoration Robotics
HAL	Halliburton
HALL	Hallmark
HALO	Halozyme Therapeutics
HARP	Harpoon Therapeutics
HAS	Hasbro
HASI	Hannon Armstrong Sustainable Infrastructure Capital
HAYN	Haynes International
HBAN	Huntington Bancsharesorporated
HBB	Hamilton Beach Brands Holding
HBCP	Home Bancorp
HBI	Hanesbrands
HBIO	Harvard Bioscience
HBM	Hudbay Minerals
HBMD	Howard Bancorp
HBNC	Horizon Bancorp
HBP	Huttig Building Products
HCA	HCA Healthcare
HCAC	Hennessy Capital Acquisition
HCAP	Harvest Capital Credit
HCC	Warrior Met Coal
HCCH	HL Acquisitions
HCCI	Heritage-Crystal Clean
HCFT	Hunt Companies Finance Trust
HCHC	HC2 Holdings
HCI	HCI Group
HCKT	The Hackett Group
HCLP	Hi-Crush Partners
HCM	Hutchison China MediTech
HCP	HCP
HCSG	Healthcare Services Group
HCXY	Hercules Capital
HD	Home Depot
HDB	HDFC Bank Limited
HDS	HD Supply Holdings
HDSN	Hudson Technologies
HE	Hawaiian Electric Industries
HEAR	Turtle Beach
HEB	Hemispherx BioPharma
HEBT	Hebron Technology
HEES	H&E Equipment Services
HEI	Heico
HELE	Helen of Troy Limited
HEP	Holly Energy Partners
HES	Hess
HESM	Hess Midstream Partners
HEXO	HEXO
HF	HFF
HFBC	HopFed Bancorp
HFBL	Home Federal Bancorp of Louisiana
HFC	HollyFrontier
HFFG	HF Foods Group
HFGIC	Hartford Funds NextShares Trust
HFRO	Highlandome Fund
HFWA	Heritage Financial
HGH	Hartford Financial Services
HGSH	China HGS Real Estate
HGV	Hilton Grand Vacations
HHC	Howard Hughes
HHHH	Wealthbridge Acquisition
HHR	HeadHunter Group
HHS	Harte-Hanks
HI	Hillenbrand
HIBB	Hibbett Sports
HIE	Miller/Howard Highome Equity Fund
HIFS	Hingham Institution for Savings
HIHO	Highway Holdings
HII	Huntington Ingalls Industries
HIIQ	Health Insurance Innovations
HIL	Hill International
HIMX	Himax Technologies
HIVE	Aerohive Networks
HIW	Highwoods Properties
HJLI	Hancock Jaffe Laboratories
HK	Halcon Resources
HL	Hecla Mining
HLF	Herbalife Nutrition
HLG	Hailiang Education Group
HLI	Houlihan Lokey
HLIT	Harmonic
HLM	Hillman Group Capital Trust
HLNE	Hamilton Laneorporated
HLT	Hilton
HLTH	Nobilis Health
HLX	Helix Energy Solutions Group
HMC	Honda
HMG	HMG/Courtland Properties
HMHC	Houghton Mifflin Harcourt Company
HMI	Huami
HMLP	Hoegh LNG Partners
HMN	Horace Mann Educators
HMNF	HMN Financial
HMST	HomeStreet
HMSY	HMS Holdings
HMTV	Hemisphere Media Group
HMY	Harmony Gold Mining
HNDL	Strategy Shares Nasdaq 7HANDL Index ETF
HNGR	Hanger
HNI	HNI
HNNA	Hennessy Advisors
HNP	Huaneng Power International
HNRG	Hallador Energy Company
HNW	Pioneer Diversified Highome Trust
HOFT	Hooker Furniture
HOG	Harley-Davidson
HOLI	Hollysys Automation Technologies
HOLX	Hologic
HOMB	Home BancShares
HOME	At Home Group
HON	Honeywell
HONE	HarborOne Bancorp
HOOK	HOOKIPA Pharma
HOPE	Hope Bancorp
HOS	Hornbeck Offshore Services
HOTH	Hoth Therapeutics
HOV	Hovnanian Enterprises
HP	Helmerich & Payne
HPE	Hewlett Packard
HPJ	Highpower International
HPP	Hudson Pacific Properties
HPQ	HP
HPR	HighPoint Resources
HPT	Hospitality Properties Trust
HQH	Tekla Healthcare Investors
HQL	Tekla Life Sciences Investors
HQY	HealthEquity
HR	Healthcare Realty Trustorporated
HRB	H&R Block
HRC	Hill-Rom Holdings
HRI	Herc Holdings
HRL	Hormel Foods
HROW	Harrow Health
HRS	Harris
HRTG	Heritage Insurance Holdings
HRTX	Heron Therapeutics
HRZN	Horizon Technology Finance
HSACU	Health Sciences Acquisitions
HSBC	HSBC Holdings
HSC	Harsco
HSDT	Helius Medical Technologies
HSGX	Histogenics
HSIC	Henry Schein
HSII	Heidrick & Struggles International
HSKA	Heska
HSON	Hudson Global
HST	Host Hotels & Resorts
HSTM	HealthStream
HSY	Hershey
HT	Hersha Hospitality Trust
HTA	Healthcare Trust of America
HTBI	HomeTrust Bancshares
HTBK	Heritage Commerce Corp
HTBX	Heat Biologics
HTGM	HTG Molecular Diagnostics
HTH	Hilltop Holdings
HTHT	Huazhu Group
HTLD	Heartland Express
HTLF	Heartland Financial USA
HTZ	Hertz Global Holdings
HUBB	Hubbell
HUBG	Hub Group
HUBS	HubSpot
HUD	Hudson
HUM	Humana
HUN	Huntsman
HURC	Hurco Companies
HURN	Huron Consulting
HUSA	Houston American Energy
HUYA	HUYA
HVBC	HV Bancorp
HVT	Haverty Furniture Companies
HWBK	Hawthorn Bancshares
HWC	Hancock Whitney
HWCC	Houston Wire & Cable Company
HWKN	Hawkins
HX	Hexindai
HXL	Hexcel
HY	Hyster-Yale Materials Handling
HYB	New America Highome Fund
HYRE	HyreCar
HZN	Horizon Global
HZNP	Horizon Therapeutics Public Limited Company
HZO	MarineMax
I	Intelsat
IAC	InterActiveCorp
IAF	Aberdeen Australia Equity Fund
IAG	Iamgold
IART	Integra LifeSciences Holdings
IBA	Industrias Bachoco
IBCP	Independent Bank
IBIO	iBio
IBKC	IBERIABANK
IBM	IBM
IBM	International Business Machines
IBN	ICICI Bank Limited
IBO	IBO
IBOC	International Bancshares
IBP	Installed Building Products
IBTX	Independent Bank Group
IBUY	Amplify Online Retail ETF
ICAD	icad
ICBK	County Bancorp
ICCC	ImmuCell
ICCH	ICC Holdings
ICD	Independence Contract Drilling
ICE	Intercontinental Exchange
ICFI	ICF International
ICHR	Ichor Holdings
ICL	Israel Chemicals Shs
ICLK	iClick Interactive
ICON	Iconix Brand
ICPT	Intercept Pharmaceuticals
ICUI	ICU Medical
IDA	IDACORP
IDCC	InterDigital
IDEX	Ideanomics
IDN	Intellicheck
IDRA	Idera Pharmaceuticals
IDSA	Industrial Services of America
IDSY	I.D. Systems
IDT	IDT
IDXG	Interpace Diagnostics
IDXX	IDEXX
IDYA	IDEAYA Biosciences
IEA	Infrastructure and Energy Alternatives
IEC	IEC Electronics
IEP	Icahn Enterprises
IESC	IES Holdings
IEX	IDEX
IFF	International Flavors & Fragrances
IFMK	iFresh
IFN	India Fund Inc.
IFRX	InflaRx
IGC	India Globalization Capital
IGLD	Internet Gold Golden Lines
IGR	CBRE Clarion Global Real Estateome Fund
IGT	International Game Technology
IHC	Independence Holding
IHG	Intercontinental Hotels
IHT	InnSuites Hospitality Trust
III	Information Services Group
IIIN	Insteel Industries
IIIV	i3 Verticals
IIPR	Innovative Industrial Properties
IIVI	II-VI Incorporated
IKNX	Ikonics
ILMN	Illumina
ILPT	Industrial Logistics Properties Trust
IMAC	IMAC
IMAX	Imax
IMGN	ImmunoGen
IMH	Impac Mortgage Holdings
IMI	Intermolecular
IMKTA	Ingles Markets,
IMMR	Immersion
IMMU	Immunomedics
IMO	Imperial Oil Limited
IMOS	ChipMOS TECHNOLOGIES
IMRN	Immuron Limited
IMTE	Integrated Media Technology Limited
IMUX	Immunic
IMV	IMV
IMXI	International Money Express
INAP	Internap
INB	Cohen & Steers Globalome Builder
INBK	First Internet Bancorp
INCY	Incyte
INDB	Independent Bank Corp.
INFI	Infinity Pharmaceuticals
INFN	Infinera
INFO	IHS Markit
INFU	InfuSystems Holdings
INFY	Infosys Limited
ING	ING Group, N.V.
INGN	Inogen
INGR	Ingredion
INMB	INmune Bio
INN	Summit Hotel Properties
INNT	Innovate Biopharmaceuticals
INO	Inovio Pharmaceuticals
INOD	Innodata
INOV	Inovalon Holdings
INPX	Inpixon
INS	Intelligent Systems
INSE	Inspired Entertainment
INSG	Inseego
INSI	Insight Selectome Fund
INSM	Insmed
INSP	Inspire Medical Systems
INST	Instructure
INSU	Insurance Acquisition
INSW	International Seaways
INSY	Insys Therapeutics
INT	World Fuel Services
INTC	Intel
INTG	The Intergroup
INTL	INTL FCStone
INTT	inTest
INTU	Intuit Inc.
INUV	Inuvo
INVA	Innoviva
INVE	Identiv
INVH	Invitation Homes
INWK	InnerWorkings
INXN	InterXion Holding
IO	Ion Geophysical
IONS	Ionis Pharmaceuticals
IOR	Income Opportunity Realty Investors
IOSP	Innospec
IOTS	Adesto Technologies
IOVA	Iovance Biotherapeutics
IP	International Paper Company
IPAR	Inter Parfums
IPB	Merrill Lynch
IPDN	Professional Diversity Network
IPG	Interpublic Group of Companies
IPGP	IPG Photonics
IPHI	Inphi
IPHS	Innophos Holdings
IPI	Intrepid Potash
IPIC	iPic Entertainment
IPLDP	Interstate Power and Light Company
IPOA	Social Capital Hedosophia Holdings
IPWR	Ideal Power
IQ	iQIYI
IQV	IQVIA Holdings
IR	Ingersoll-Rand
IRBT	iRobot
IRCP	IRSA Propiedades Comerciales
IRDM	Iridium Communications
IRET	Investors Real Estate Trust
IRIX	IRIDEX
IRL	New Ireland Fund
IRM	Iron Mountain
IRMD	iRadimed
IROQ	IF Bancorp
IRS	IRSA Inversiones Y Representaciones
IRT	Independence Realty Trust
IRTC	iRhythm Technologies
IRWD	Ironwood Pharmaceuticals
ISBC	Investors Bancorp
ISCA	International Speedway
ISDR	Issuer Direct
ISEE	IVERIC bio
ISIG	Insignia Systems
ISNS	Image Sensing Systems
ISR	IsoRay
ISRG	Intuitive Surgical
ISRL	Isramco
ISSC	Innovative Solutions and Support
ISTR	Investar Holding
IT	Gartner
ITCB	Itau CorpBanca
ITCI	Intra-Cellular Therapies
ITEQ	BlueStar Israel Technology
ITGR	Integer Holdings
ITI	Iteris
ITIC	Investors Title Company
ITMR	Itamar Medical
ITP	IT Tech Packaging
ITRI	Itron
ITRM	Iterum Therapeutics
ITRN	Ituran Location and Control
ITT	ITT
ITUB	Itau Unibanco Banco Holding SA
ITW	Illinois Tool Works
IVAC	Intevac
IVC	Invacare
IVENC	Ivy NextShares
IVZ	Invesco
IX	Orix Corp Ads
IZEA	IZEA Worldwide
JACK	Jack In The Box
JAG	Jagged Peak Energy
JAGX	Jaguar Health
JAKK	JAKKS Pacific
JASN	Jason Industries
JAX	J. Alexander's Holdings
JAZZ	Jazz Pharmaceuticals
JBGS	JBG SMITH Properties
JBHT	J.B. Hunt Transport Services
JBK	Lehman ABS
JBL	Jabil
JBLU	JetBlue
JBN	Select Asset
JBSS	John B. Sanfilippo & Son
JBT	John Bean Technologies
JCAP	Jernigan Capital
JCI	Johnson Controls International
JCOM	j2 Global
JCP	J.C. Penney
JCS	Communications Systems
JCTCF	Jewett-Cameron Trading Company
JD	JD.com
JE	Just Energy Group
JEC	Jacobs Engineering Group
JEF	Jefferies Financial Group
JELD	JELD-WEN Holding
JEQ	Aberdeen Japan Equity Fund
JFIN	Jiayin Group
JFK	8i Enterprises Acquisition
JG	Aurora Mobile Limited
JHG	Janus Henderson
JHI	John Hancock Investors Trust
JHX	James Hardie Industries
JILL	J. Jill
JJSF	J & J Snack Foods
JKHY	Jack Henry & Associates
JKS	JinkoSolar
JLL	Jones Lang LaSalle
JMEI	Jumei International
JMIA	Jumia Technologies
JMP	JMP Group
JMU	JMU Limited
JNCE	Jounce Therapeutics
JNJ	Johnson & Johnson
JNPR	Juniper Networks
JOB	GEE Group
JOBS	51job
JOE	St. Joe Company
JOF	Japan Smaller Capitalization Fund
JOUT	Johnson Outdoors
JP	Jupai Holdings Limited
JPM	J P Morgan Chase
JRJC	China Finance Online
JRSH	Jerash Holdings
JRVR	James River Group Holdings
JSM	Navient
JSYN	Jensyn Acquistion
JT	Jianpu Technology
JVA	Coffee Holding
JW.A	John Wiley & Sons
JWN	Nordstrom
JYNT	The Joint
K	Kellogg Company
KAI	Kadant
KALA	Kala Pharmaceuticals
KALU	Kaiser Aluminum
KALV	KalVista Pharmaceuticals
KAMN	Kaman
KAR	KAR Auction Services
KB	KB Financial Group
KBAL	Kimball International
KBH	KB Home
KBLM	KBL Merger IV
KBR	KBR
KBSF	KBS Fashion Group
KCAPL	Portman Ridge Finance
KDMN	Kadmon Holdings
KDP	Keurig Dr Pepper
KE	Kimball Electronics
KEG	Key Energy Services
KELYA	Kelly Services
KEM	Kemet
KEN	Kenon Holdings
KEP	Korea Electric Power
KEQU	Kewaunee Scientific
KEX	Kirby
KEY	KeyCorp
KEYS	Keysight Technologies
KEYW	The KEYW Holding
KF	Korea Fund Inc
KFFB	Kentucky First Federal Bancorp
KFRC	Kforce
KFS	Kingsway Financial Services
KFY	Korn Ferry
KGC	Kinross Gold
KGJI	Kingold Jewelry
KHC	The Kraft Heinz
KIDS	OrthoPediatrics
KIM	Kimco Realty
KIN	Kindred Biosciences
KINS	Kingstone Companies
KIO	KKRome Opportunities Fund
KIQ	Kelso Technologies
KIRK	Kirkland's
KKR	KKR
KL	Kirkland Lake Gold
KLAC	KLA-Tencor
KLDO	Kaleido Biosciences
KLIC	Kulicke and Soffa Industries
KLXE	KLX Energy Services
KMB	Kimberly-Clark
KMDA	Kamada
KMF	Kayne Anderson Midstream Energy Fund
KMI	Kinder Morgan
KMPA	Kemper
KMPH	KemPharm
KMT	Kennametal
KMX	CarMax
KN	Knowles
KNDI	Kandi Technologies Group
KNL	Knoll
KNOP	KNOT Offshore Partners
KNSA	Kiniksa Pharmaceuticals
KNSL	Kinsale Capital
KNX	Knight Transportation
KOD	Kodiak Sciences
KODK	Eastman Kodak Company
KOOL	Cesca Therapeutics
KOP	Koppers Holdings
KOPN	Kopin
KOS	Kosmos Energy
KOSS	Koss
KPFS	Pepper Food Service
KPTI	Karyopharm Therapeutics
KR	Kroger Company
KRA	Kraton
KRC	Kilroy Realty
KREF	KKR Real Estate Finance Trust
KRG	Kite Realty Group Trust
KRNT	Kornit Digital
KRNY	Kearny Financial
KRO	Kronos Worldwide
KRP	Kimbell Royalty Partners
KRYS	Krystal Biotech
KSM	Scudder Strategic Municipleome Trust
KSS	Kohl's
KSU	Kansas City Southern
KT	KT Corporation
KTB	Kontoor Brands
KTCC	Key Tronic
KTF	Scudder Municipleome Trust
KTOS	Kratos Defense & Security Solutions
KTOV	Kitov Pharma
KURA	Kura Oncology
KVHI	KVH Industries
KW	Kennedy-Wilson Holdings
KWEB	KraneShares Trust KraneShares CSI China Internet ETF
KWR	Quaker Chemical
KXIN	Kaixin Auto
KYN	Kayne Anderson MLP/Midstream Investment Company
KZIA	Kazia Therapeutics Limited
KZR	Kezar Life Sciences
L	Loews Corporation
LABL	Multi-Color
LAC	Lithium Americas
LACQ	Leisure Acquisition
LAD	Lithia Motors
LADR	Ladder Capital
LAIX	LAIX
LAKE	Lakeland Industries
LAMR	Lamar Advertising
LANC	Lancaster Colony
LARK	Landmark Bancorp
LASR	nLIGHT
LAUR	Laureate Education
LAWS	Lawson Products
LAZ	Lazard
LAZY	Lazydays
LB	L Brands
LBAI	Lakeland Bancorp
LBC	Luther Burbank
LBRDA	Liberty Broadband
LBRT	Liberty Oilfield Services
LBTYA	Liberty Global
LBY	Libbey
LC	LendingClub
LCAHU	Landcadia Holdings
LCI	Lannett
LCII	LCI Industries
LCNB	LCNB
LCUT	Lifetime Brands
LDL	Lydall
LDOS	Leidos
LE	Lands' End
LEA	Lear
LEAF	Leaf Group
LECO	Lincoln Electric Holdings
LEDS	SemiLEDS
LEE	Lee Enterprises
LEG	Leggett & Platt
LEGH	Legacy Housing
LEJU	Leju Holdings Limited
LEN	Lennar
LEU	Centrus Energy
LEVI	Levi Strauss
LEVL	Level One Bancorp
LEXEA	Liberty Expedia Holdings
LFAC	LF Capital Acquistion
LFC	China Life Insurance Company Limited
LFUS	Littelfuse
LFVN	Lifevantage
LGC	Legacy Acquisition
LGCY	Legacy Reserves
LGF.A	Lions Gate Entertainment
LGI	Lazard Global Total Return andome Fund
LGIH	LGI Homes
LGL	LGL Group
LGND	Ligand Pharmaceuticals
LH	Laboratory of America Holdings
LHC	Leo Holdings
LHCG	LHC Group
LIFE	aTyr Pharma
LII	Lennox International
LILA	Liberty Latin America
LIN	Linde
LINC	Lincoln Educational Services
LIND	Lindblad Expeditions
LION	Fidelity Southern
LIQT	LiqTech International
LITB	LightInTheBox Holding
LITE	Lumentum Holdings
LIVE	Live Ventures
LIVN	LivaNova
LIVX	LiveXLive Media
LJPC	La Jolla Pharmaceutical Company
LK	Luckin Coffee
LKCO	Luokung Technology
LKFN	Lakeland Financial
LKQ	LKQ
LKSD	LSC Communications
LL	Lumber Liquidators Holdings
LLEX	Lilis Energy
LLIT	Lianluo Smart Limited
LLL	L3 Technologies
LLNW	Limelight Networks
LLY	Eli Lilly
LM	Legg Mason
LMAT	LeMaitre Vascular
LMB	Limbach Holdings
LMFA	LM Funding America
LMNR	Limoneira
LMNX	Luminex
LMRK	Landmark Infrastructure Partners
LMST	Limestone Bancorp
LMT	Lockheed Martin
LN	LINE Corporation
LNC	Lincoln National
LND	Brasilagro Cia Brasileira De Propriedades Agricolas
LNDC	Landec
LNG	Cheniere Energy
LNN	Lindsay Corporation
LNT	Alliant Energy
LNTH	Lantheus Holdings
LOAC	Longevity Acquisition
LOAN	Manhattan Bridge Capital
LOB	Live Oak Bancshares
LOCO	El Pollo Loco Holdings
LODE	Comstock Mining
LOGC	LogicBio Therapeutics
LOGI	Logitech International
LOGM	LogMein
LOMA	Loma Negra Compania Industrial Argentina Sociedad Anonima
LONE	Lonestar Resources
LOOP	Loop Industries
LOPE	Grand Canyon Education
LOR	Lazard World Dividend & Income Fund
LORL	Loral Space and Communications
LOV	Spark Networks
LOVE	The Lovesac Company
LOW	Lowe's Companies
LPCN	Lipocine
LPG	DorianG
LPI	Laredo Petroleum
LPL	LG Display
LPLA	LPL Financial Holdings
LPSN	LivePerson
LPT	Liberty Property Trust
LPTH	LightPath Technologies
LPTX	LEAP THERAPEUTICS
LPX	Louisiana-Pacific
LQDA	Liquidia Technologies
LQDT	Liquidity Services
LRAD	LRAD
LRCX	Lam Research
LRN	K12
LSBK	Lake Shore Bancorp
LSCC	Lattice Semiconductor
LSI	Life Storage
LSTR	Landstar System
LTBR	Lightbridge
LTC	LTC Properties
LTHM	Livent
LTM	LATAM Airlines Group
LTRPA	Liberty TripAdvisor
LTRX	Lantronix
LTS	Ladenburg Thalmann Financial Services
LTXB	LegacyTexas Financial Group
LUB	Luby's
LULU	lululemon athletica
LUNA	Luna Innovations
LUV	Southwest Airlines
LVS	Las Vegas Sands
LW	Lamb Weston
LWAY	Lifeway Foods
LX	LexinFintech
LXFR	Luxfer
LXFT	Luxoft Holding
LXP	Lexington Realty Trust
LXRX	Lexicon Pharmaceuticals
LXU	Lsb Industries
LYB	LyondellBasell Industries
LYFT	Lyft
LYG	Lloyds Banking Group Plc
LYL	Dragon Victory International Limited
LYTS	LSI Industries
LYV	Live Nation Entertainment
LZB	La-Z-Boy
M	Macy's
MA	Mastercard
MAA	Mid-America Apartment Communities
MAC	Macerich Company
MACK	Merrimack Pharmaceuticals
MAG	MAG Silver
MAGS	Magal Security Systems
MAIN	Main Street Capital
MAMS	MAM Software Group
MAN	ManpowerGroup
MANH	Manhattan Associates
MANT	ManTech International
MANU	Manchester United
MAR	Marriott International
MARA	Marathon Patent Group
MARK	Remark Holdings
MARPS	Marine Petroleum Trust
MAS	Masco
MASI	Masimo
MAT	Mattel
MATW	Matthews International
MATX	Matson
MAV	Pioneer Municipal Highome Advantage Trust
MAXR	Maxar Technologies
MAYS	J. W. Mays
MBCN	Middlefield Banc
MBI	MBIA
MBII	Marrone Bio Innovations
MBIN	Merchants Bancorp
MBIO	Mustang Bio
MBOT	Microbot Medical
MBRX	Moleculin Biotech
MBT	Mobile TeleSystems
MBTF	M B T Financial
MBUU	Malibu Boats
MBWM	Mercantile Bank
MC	Moelis
MCB	Metropolitan Bank
MCBC	Macatawa Bank
MCC	Medley Capital
MCD	McDonald's
MCEP	Mid-Con Energy Partners
MCF	Contango Oil & Gas
MCFT	MasterCraft Boat
MCHP	Microchip Technology
MCHX	Marchex
MCI	Barings Corporate Investors
MCK	McKesson
MCN	Madison Covered Call & Equity Strategy Fund
MCO	Moody's
MCR	MFS Charterome Trust
MCRB	Seres Therapeutics
MCRI	Monarch Casino & Resort
MCRN	Milacron Holdings
MCS	Marcus
MCY	Mercury General
MD	Mednax
MDB	MongoDB
MDC	M.D.C. Holdings
MDCA	MDC Partners
MDCO	The Medicines Company
MDGL	Madrigal Pharmaceuticals
MDGS	Medigus
MDJH	MDJM
MDLQ	Medley
MDLY	Medley Management
MDLZ	Mondelez International
MDP	Meredith
MDR	McDermott
MDRR	Medalist Diversified REIT
MDRX	Allscripts Healthcare Solutions
MDSO	Medidata Solutions
MDT	Medtronic
MDU	MDU Resources Group
MDWD	MediWound
MEC	Mayville Engineering
MED	MEDIFAST
MEDP	Medpace
MEET	The Meet Group
MEI	Methode Electronics
MEIP	MEI Pharma
MELI	MercadoLibre
MELR	Melrose Bancorp
MEOH	Methanex
MER	Merrill Lynch
MERC	Mercer International
MESA	Mesa Air Group
MESO	Mesoblast Limited
MET	MetLife
METC	Ramaco Resources
MFA	MFA Financial
MFAC	Megalith Financial Acquisition
MFC	Manulife Financial
MFCB	MFC Bancorp
MFD	Macquarie First Trust Global
MFG	Mizuho
MFGP	Micro Focus
MFIN	Medallion Financial
MFM	MFS Municipalome Trust
MFNC	Mackinac Financial
MFSF	MutualFirst Financial
MFV	MFS Special Value Trust
MG	Mistras Group
MGA	Magna
MGEE	MGE Energy
MGEN	Miragen Therapeutics
MGF	MFS Government Marketsome Trust
MGI	Moneygram International
MGIC	Magic Software Enterprises
MGLN	Magellan Health
MGM	MGM Resorts
MGNX	MacroGenics
MGP	MGM Growth Properties
MGPI	MGP Ingredients
MGRC	McGrath RentCorp
MGTA	Magenta Therapeutics
MGTX	MeiraGTx
MGU	Macquarie Global Infrastructure Total Return Fund
MGY	Magnolia Oil & Gas
MGYR	Magyar Bancorp
MH	Maiden Holdings
MHH	Mastech Digital
MHI	Pioneer Municipal Highome Trust
MHK	Mohawk Industries
MHO	M/I Homes
MIC	Macquarie Infrastructure
MICR	Micron Solutions
MICT	MICT
MIDD	The Middleby
MIK	The Michaels Companies
MIME	Mimecast Limited
MIN	MFS Intermediateome Trust
MIND	Mitcham Industries
MINI	Mobile Mini
MIST	Milestone Pharmaceuticals
MITK	Mitek Systems
MITO	Stealth BioTherapeutics
MITT	AG Mortgage Investment Trust
MIXT	MiX Telematics
MJCO	Majesco
MKC	McCormick
MKGI	Monaker Group
MKL	Markel
MKSI	MKS Instruments
MKTX	MarketAxess
MLAB	Mesa Laboratories
MLCO	Melco Resorts & Entertainment
MLHR	Herman Miller
MLI	Mueller Industries
MLM	Martin Marietta Materials
MLND	Millendo Therapeutics
MLNT	Melinta Therapeutics
MLNX	Mellanox Technologies
MLP	Maui Land & Pineapple
MLR	Miller Industries
MLSS	Milestone Scientific
MLVF	Malvern Bancorp
MMAC	MMA Capital
MMC	Marsh & McLennan
MMD	MainStay MacKay DefinedTerm Municipal Opportunitie
MMDM	Modern Media Acquisition
MMI	Marcus & Millichap
MMLP	Martin Midstream Partners
MMM	3M Company
MMP	Magellan Midstream Partners
MMS	Maximus
MMSI	Merit Medical Systems
MMT	MFS Multimarketome Trust
MMYT	MakeMyTrip
MN	Manning & Napier
MNCL	Monocle Acquisition
MNDO	MIND C.T.I.
MNI	McClatchy Company
MNK	Mallinckrodt
MNKD	MannKind
MNLO	Menlo Therapeutics
MNOV	MediciNova
MNR	Monmouth Real Estate Investment
MNRL	Brigham Minerals
MNRO	Monro
MNSB	MainStreet Bancshares
MNST	Monster Beverage
MNTA	Momenta Pharmaceuticals
MNTX	Manitex International
MO	Altria Group
MOBL	MobileIron
MOD	Modine Manufacturing Company
MODN	Model N
MOFG	MidWestOne Financial Group
MOG.A	Moog
MOGO	Mogo Finance Technology
MOGU	MOGU
MOH	Molina Healthcare
MOMO	Momo Inc.
MOR	MorphoSys
MORN	Morningstar
MOS	Mosaic Company
MOSC	Mosaic Acquisition
MOSY	MoSys
MOTS	Motus GI
MOV	Movado Group
MOXC	Moxian
MPAA	Motorcar Parts of America
MPB	Mid Penn Bancorp
MPC	Marathon Petroleum
MPLX	MPLX
MPO	MIDSTATES PETROLEUM
MPV	Barings Participation Investors
MPVD	Mountain Province Diamonds
MPW	Medical Properties Trust
MPWR	Monolithic Power Systems
MPX	Marine Products
MR	Montage Resources
MRAM	Everspin Technologies
MRBK	Meridian
MRC	MRC Global
MRCC	Monroe Capital
MRCY	Mercury Systems
MREO	Mereo BioPharma Group
MRIN	Marin Software
MRK	Merck
MRKR	Marker Therapeutics
MRLN	Marlin Business Services
MRNA	Moderna
MRNS	Marinus Pharmaceuticals
MRO	Marathon Oil
MRSN	Mersana Therapeutics
MRTN	Marten Transport
MRTX	Mirati Therapeutics
MRUS	Merus
MRVL	Marvell Technology Group
MS	Morgan Stanley
MSA	MSA Safetyorporporated
MSB	Mesabi Trust
MSBF	MSB Financial
MSBI	Midland States Bancorp
MSC	Studio City International
MSCI	MSCI
MSEX	Middlesex Water
MSFT	Microsoft
MSG	The Madison Square Garden Company
MSGN	MSG Networks
MSI	Motorola Solutions
MSL	MidSouth Bancorp
MSM	MSC Industrial Direct Company
MSN	Emerson Radio
MSON	MISONIX
MSTR	MicroStrategy
MSVB	Mid-Southern Bancorp
MT	ArcelorMittal
MTB	M&T Bank
MTBC	MTBC
MTC	MMTec
MTCH	Match Group
MTD	Mettler-Toledo International
MTDR	Matador Resources Company
MTEC	MTech Acquisition
MTEM	Molecular Templates
MTEX	Mannatech
MTFB	Motif Bio
MTG	MGIC Investment
MTH	Meritage
MTL	Mechel PAO
MTLS	Materialise
MTN	Vail Resorts
MTNB	Matinas Biopharma
MTOR	Meritor
MTP	Midatech Pharma
MTR	Mesa Royalty Trust
MTRN	Materion
MTRX	Matrix Service Company
MTSC	MTS Systems
MTSI	MACOM Technology Solutions
MTSL	MER Telemanagement Solutions
MTW	Manitowoc Company
MTX	Minerals Technologies
MTZ	MasTec
MU	Micron Technology
MUDS	Mudrick Capital Acquisition
MUFG	Mitsubishi UFJ Financial Group
MUR	Murphy Oil
MUSA	Murphy USA
MUX	McEwen Mining
MVBF	MVB Financial
MVC	MVC Capital
MVF	MuniVest Fund
MVIS	Microvision
MVO	MV Oil Trust
MWA	Mueller Water Products
MX	MagnaChip Semiconductor
MXC	Mexco Energy
MXE	Mexico Equity andome Fund
MXF	Mexico Fund
MXIM	Maxim Integrated Products
MXL	MaxLinear
MYE	Myers Industries
MYFW	First Western Financial
MYGN	Myriad Genetics
MYL	Mylan
MYND	MYnd Analytics
MYO	Myomo
MYOK	MyoKardia
MYOS	MYOS RENS Technology
MYOV	Myovant Sciences
MYRG	MYR Group
MYSZ	My Size, Inc.
MYT	Urban Tea
MZA	MuniYield Arizona Fund
NAK	Northern Dynasty Minerals
NAKD	Naked Brand Group
NANO	Nanometrics
NAO	Nordic American Offshore
NAOV	NanoVibronix
NAT	Nordic American Tankers
NATH	Nathan's Famous
NATR	Nature's Sunshine Products
NAV	Navistar International
NAVB	Navidea Biopharmaceuticals
NBEV	New Age Beverages
NBIX	Neurocrine Biosciences
NBL	Noble Energy
NBLX	Noble Midstream Partners
NBN	Northeast Bank
NBR	Nabors Industries
NBRV	Nabriva Therapeutics
NBTB	NBT Bancorp
NBY	NovaBay Pharmaceuticals
NC	NACCO Industries
NCBS	Nicolet Bankshares
NCI	Navigant Consulting
NCLH	Norwegian Cruise Line
NCNA	NuCana
NCR	NCR
NCSM	NCS Multistage
NCTY	The9 Limited
NCV	AllianzGI Convertible &ome Fund
NDAQ	Nasdaq
NDLS	Noodles & Company
NDP	Tortoise Energy Independence Fund
NDRA	ENDRA Life Sciences
NDSN	Nordson
NE	Noble
NEBU	Nebula Acquisition
NEM	Newmont Goldcorp
NEN	New England Realty Associates Limited Partnership
NEO	NeoGenomics
NEOG	Neogen
NEON	Neonode
NEOS	Neos Therapeutics
NEP	NextEra Energy Partners
NEPT	Neptune Wellness Solutions
NERV	Minerva Neurosciences
NES	Nuverra Environmental Solutions
NETE	Net Element
NETS	Netshoes
NEU	NewMarket
NEW	Puxin Limited
NEWA	Newater Technology
NEWM	New Media Investment Group
NEWR	New Relic
NEWT	Newtek Business Services
NEXA	Nexa Resources
NEXT	NextDecade
NFBK	Northfield Bancorp
NFC	New Frontier Corporation
NFE	New Fortress Energy
NFJ	AllianzGI NFJ Dividend, Interest & Premium Strategy Fund
NFLX	Netflix
NG	Novagold Resources
NGD	New Gold Inc.
NGL	NGL ENERGY PARTNERS
NGLS	Targa Resources Partners
NGM	NGM Biopharmaceuticals
NGVT	Ingevity
NH	NantHealth
NHF	NexPoint Strategic Opportunities Fund
NI	NiSource
NICE	NICE Ltd
NICK	Nicholas Financial
NIE	AllianzGI Equity & Convertibleome Fund
NIHD	NII Holdings
NINE	Nine Energy Service
NIO	NIO
NITE	Nightstar Therapeutics
NIU	Niu Technologies
NJR	NewJersey Resources
NK	NantKwest
NKE	Nike
NKTR	Nektar Therapeutics
NL	NL Industries
NLNK	NewLink Genetics
NLS	Nautilus Group
NLSN	Nielsen
NLY	Annaly Capital Management
NM	Navios Maritime
NMFC	New Mountain Finance
NMIH	NMI Holdings
NMK	Niagara Mohawk
NMR	Nomura
NMRD	Nemaura Medical
NMRK	Newmark Group
NNBR	NN
NNDM	Nano Dimension
NNI	Nelnet
NNVC	NanoViricides
NOA	North American Construction
NOAH	Noah Holdings
NOC	Northrop Grumman
NODK	NI Holdings
NOG	Northern Oil and Gas
NOK	Nokia
NOMD	Nomad Foods
NOVN	Novan
NOVT	Novanta
NOW	ServiceNow
NP	Neenah
NPO	EnPro Industries
NPTN	NeoPhotonics
NR	Newpark Resources
NRCG	NRC Group
NRE	NorthStar Realty Europe
NRG	NRG Energy
NRIM	Northrim BanCorp
NRT	North European Oil Royality
NRZ	New Residential Investment
NS	Nustar Energy
NSC	Norfolk Souther
NSIT	Insight Enterprises
NSP	Insperity
NSPR	InspireMD
NSS	NuStar Logistics
NSSC	NAPCO Security Technologies
NSTG	NanoString Technologies
NSYS	Nortech Systems
NTAP	NetApp
NTB	Bank of N.T. Butterfield & Son
NTCT	NetScout Systems
NTEC	Intec Pharma
NTES	NetEase
NTG	Tortoise Midstream Energy Fund
NTGN	Neon Therapeutics
NTGR	NETGEAR
NTIC	Northern Technologies International
NTIP	Network-1 Technologies
NTLA	Intellia Therapeutics
NTN	NTN Buzztime
NTNX	Nutanix
NTP	Nam Tai Property
NTR	Nutrien
NTRA	Natera
NTRP	Neurotrope
NTRS	Northern Trust
NTWK	NetSol Technologies
NTZ	Natuzzi
NUAN	Nuance Communications
NUE	Nucor
NURO	NeuroMetrix
NUS	Nu Skin Enterprises
NUVA	NuVasive
NVAX	Novavax
NVCN	Neovasc
NVCR	NovoCure
NVDA	NVIDIA
NVEC	NVE
NVEE	NV5 Global
NVFY	Nova Lifestyle
NVGS	Navigator Holdings
NVIV	InVivo Therapeutics
NVLN	Novelion Therapeutics
NVMI	Nova Measuring Instruments
NVO	Novo Nordisk
NVR	NVR
NVRO	Nevro
NVS	Novartis
NVT	nVent Electric
NVTA	Invitae
NVTR	Nuvectra
NVUS	Novus Therapeutics
NWBI	Northwest Bancshares
NWE	NorthWestern
NWFL	Norwood Financial
NWHM	New Home Company
NWL	Newell Brands
NWN	Northwest Natural
NWPX	Northwest Pipe
NWS	News Corporation
NX	Quanex Building Products
NXE	Nexgen Energy
NXGN	NextGen Healthcare
NXPI	NXP Semiconductors
NXRT	NexPoint Residential Trust
NXST	Nexstar Media
NXTC	NextCure
NXTD	NXT-ID
NYCB	New York Community Bancorp
NYMT	New York Mortgage Trust
NYMX	Nymox Pharmaceutical
NYNY	Empire Resorts
NYT	New York Times
O	Realtyome
OAK	Oaktree Capital
OAS	Oasis Petroleum
OASM	Oasmia Pharmaceutical
OBAS	Optibase
OBCI	Ocean Bio-Chem
OBE	Obsidian Energy
OBLN	Obalon Therapeutics
OBNK	Origin Bancorp
OBSV	ObsEva
OC	Owens Corning
OCC	Optical Cable
OCCI	OFS Credit
OCFC	OceanFirst Financial
OCN	Ocwen Financial
OCSL	Oaktree Specialty Lending
OCUL	Ocular Therapeutix
OCX	OncoCyte
ODC	Oil-Dri Of America
ODFL	Old Dominion Freight Line
ODP	Office Depot
ODT	Odonate Therapeutics
OEC	Orion Engineered Carbons
OESX	Orion Energy Systems
OFC	Corporate Office Properties Trust
OFED	Oconee Federal Financial
OFG	OFG Bancorp
OFIX	Orthofix Medical
OFLX	Omega Flex
OFS	OFS Capital
OGE	OGE Energy
OGEN	Oragenics
OGI	Organigram Holdings
OGS	ONE Gas
OHAI	OHA Investment
OHI	Omega Healthcare Investors
OHRP	Ohr Pharmaceutical
OI	Owens-Illinois
OII	Oceaneering International
OIIM	O2Micro International Limited
OIS	Oil States International
OKE	ONEOK
OKTA	Okta
OLBK	Old Line Bancshares
OLD	The Long-Term Care ETF
OLED	Universal Display Corporation
OLLI	Ollie's Bargain Outlet
OLN	Olin Corporation
OLP	One Liberty Properties
OMAB	Grupo Aeroportuario del Centro Norte
OMAD	One Madison Corporation
OMC	Omnicom Group
OMCL	Omnicell
OMER	Omeros
OMEX	Odyssey Marine Exploration
OMF	OneMain Holdings
OMI	Owens & Minor
OMN	OMNOVA Solutions
OMP	Oasis Midstream Partners
ON	ON Semiconductor
ONB	Old National Bancorp
ONCE	Spark Therapeutics
ONCS	OncoSec Medical
ONCY	Oncolytics Biotech
ONDK	On Deck Capital
ONE	OneSmart International Education
ONEQ	Fidelity Nasdaq Composite Index Tracking Stock
ONTX	Onconova Therapeutics
ONVO	Organovo
OOMA	Ooma
OPB	Opus Bank
OPBK	OP Bancorp
OPES	Opes Acquisition
OPGN	OpGen
OPHC	OptimumBank
OPI	Office Propertiesome Trust
OPK	Opko Health
OPNT	Opiant Pharmaceuticals
OPOF	Old Point Financial
OPRA	Opera Limited
OPRX	OptimizeRx
OPTN	OptiNose
OPTT	Ocean Power Technologies
OPY	Oppenheimer
OR	Osisko Gold Royalties Ltd
ORA	Ormat Technologies
ORAN	Orange
ORBC	ORBCOMM
ORC	Orchid Island Capital
ORCL	Oracle
ORG	The Organics ETF
ORGO	Organogenesis
ORGS	Orgenesis
ORI	Old Republic International
ORIT	Oritani Financial
ORLY	O'Reilly Automotive
ORMP	Oramed Pharmaceuticals
ORN	Orion Group
ORRF	Orrstown Financial Services
ORTX	Orchard Therapeutics
OSB	Norbord
OSBC	Old Second Bancorp
OSG	Overseas Shipholding Group
OSIS	OSI Systems
OSK	Oshkosh
OSMT	Osmotica Pharmaceuticals
OSN	Ossen Innovation Co.
OSPN	OneSpan
OSS	One Stop Systems
OSTK	Overstock
OSTK	Overstock.com
OSUR	OraSure Technologies
OSW	OneSpaWorld
OTEL	Otelco
OTEX	Open Text Corporation
OTIC	Otonomy
OTIV	On Track Innovations
OTLK	Outlook Therapeutics
OTTR	Otter Tail
OTTW	Ottawa Bancorp
OUT	OUTFRONT Media
OVBC	Ohio Valley Banc
OVID	Ovid Therapeutics
OVLY	Oak Valley Bancorp
OXBR	Oxbridge Re
OXFD	Oxford Immunotec Global
OXLC	Oxford Lane Capital
OXM	Oxford Industries
OXSQ	Oxford Square Capital
OXY	Occidental Petroleum
OZK	Bank OZK
OZM	Och-Ziff Capital Management
PAA	Plains All American Pipeline
PAACU	Proficient Alpha Acquisition
PAAS	Pan American Silver
PAC	Grupo Aeroportuario Del Pacifico
PACB	Pacific Biosciences of California
PACD	Pacific Drilling
PACQ	Pure Acquisition
PACW	PacWest Bancorp
PAG	Penske Automotive Group
PAGP	Plains Group Holdings
PAGS	PagSeguro Digital
PAHC	Phibro Animal Health
PAM	Pampa Energia
PANL	Pangaea Logistics Solutions
PANW	Palo Alto Networks
PAR	PAR Technology
PARR	Par Pacific
PATI	Patriot Transportation
PATK	Patrick Industries
PAVM	PAVmed
PAYC	Paycom Software
PAYS	Paysign
PAYX	Paychex
PB	Prosperity Bancshares
PBA	Pembina Pipeline
PBBI	PB Bancorp
PBCT	People's United Financial
PBF	PBF Energy
PBFX	PBF Logistics
PBH	Prestige Consumer Healthcare
PBHC	Pathfinder Bancorp
PBI	Pitney Bowes
PBIP	Prudential Bancorp
PBPB	Potbelly
PBR	Petroleo Brasileiro
PBT	Permian Basin Royalty Trust
PBTS	Powerbridge Technologies
PBY	Prospect Capital
PBYI	Puma Biotechnology
PCAR	PACCAR
PCB	Pacific City Financial
PCG	Pacific Gas & Electric
PCH	PotlatchDeltic
PCMI	PCM, Inc.
PCOM	Points International
PCRX	Pacira BioSciences
PCSB	PCSB Financial
PCTI	PC-Tel
PCTY	Paylocity
PCYG	Park City Group
PCYO	Pure Cycle
PD	PagerDuty
PDCE	PDC Energy
PDCO	Patterson Companies
PDD	Pinduoduo
PDEX	Pro-Dex
PDFS	PDF Solutions
PDLB	PDL Community Bancorp
PDLI	PDL BioPharma
PDM	Piedmont Office Realty Trust
PDS	Precision Drilling
PDSB	PDS Biotechnology
PDVW	pdvWireless
PE	Parsley Energy
PEB	Pebblebrook Hotel Trust
PEBK	Peoples Bancorp of North Carolina
PEBO	Peoples Bancorp
PED	Pedevco
PEG	Public Service Enterprise Group
PEGA	Pegasystems
PEGI	Pattern Energy Group
PEI	Pennsylvania Real Estate Investment Trust
PEIX	Pacific Ethanol
PEN	Penumbra
PENN	Penn National Gaming
PEO	Adams Natural Resources Fund
PEP	Pepsico
PER	SandRidge Permian Trust
PERI	Perion Network
PES	Pioneer Energy Services
PESI	Perma-Fix Environmental Services
PETQ	PetIQ
PETS	PetMed Express
PETX	Aratana Therapeutics
PETZ	TDH Holdings
PFBC	Preferred Bank
PFBI	Premier Financial Bancorp
PFE	Pfizer
PFG	Principal Financial Group
PFGC	Performance Food Group
PFIE	Profire Energy
PFIN	P & F Industries
PFIS	Peoples Financial Services
PFLT	PennantPark Floating Rate Capital
PFMT	Performant Financial
PFNX	Pfenex
PFPT	Proofpoint
PFS	Provident Financial Services
PFSI	PennyMac Financial Services
PFSW	PFSweb
PG	Procter & Gamble
PGC	Peapack-Gladstone Financial
PGNX	Progenics Pharmaceuticals
PGR	Progressive Corporation
PGRE	Paramount Group
PGTI	PGT Innovations
PH	Parker-Hannifin
PHAS	PhaseBio Pharmaceuticals
PHCF	PUHUI WEALTH INVESTMENT MANAGEMENT
PHD	Pioneer Floating Rate Trust
PHG	Koninklijke Philips
PHI	PLDT
PHIO	Phio Pharmaceuticals
PHK	Pimco
PHM	PulteGroup
PHT	Pioneer Highome Trust
PHUN	Phunware
PHX	Panhandle Royalty
PI	Impinj
PICO	PICO
PIH	1347 Property Insurance
PII	Polaris Industries
PIM	Putnam Master Intermediateome Trust
PINC	Premier
PINS	Pinterest
PIR	Pier 1 Imports
PIRS	Pieris Pharmaceuticals
PIXY	ShiftPixy
PIY	Merrill Lynch Depositor
PJC	Piper Jaffray
PJH	Prudential Financial
PJT	PJT Partners
PK	Park Hotels & Resorts
PKBK	Parke Bancorp
PKD	Parker Drilling Company
PKE	Park Electrochemical
PKG	Packaging of America
PKI	PerkinElmer
PKOH	Park-Ohio Holdings
PKX	POSCO
PLAB	Photronics
PLAG	Planet Green Holdings
PLAN	Anaplan
PLAY	Dave & Buster's Entertainment
PLBC	Plumas Bancorp
PLCE	Children's Place
PLD	Prologis
PLG	Platinum Group Metals
PLL	Piedmont Lithium Limited
PLM	Polymet Mining
PLMR	Palomar
PLNT	Planet Fitness
PLOW	Douglas Dynamics
PLPC	Preformed Line Products
PLSE	Pulse Biosciences
PLT	Plantronics
PLUG	Plug Power
PLUS	ePlus
PLX	Protalix BioTherapeutics
PLXP	PLx Pharma
PLXS	Plexus
PLYA	Playa Hotels & Resorts
PLYM	Plymouth Industrial REIT
PM	Philip Morris International
PMBC	Pacific Mercantile Bancorp
PMD	Psychemedics
PME	Pingtan Marine Enterprise
PMM	Putnam Managed Municipalome Trust
PMO	Putnam Municipal Opportunities Trust
PMT	PennyMac Mortgage Investment Trust
PMTS	CPI Card Group
PNBK	Patriot National Bancorp
PNC	PNC Financial Services Group
PNFP	Pinnacle Financial Partners
PNM	PNM Resources
PNNT	PennantPark Investment
PNR	Pentair
PNRG	PrimeEnergy Resources
PNRL	Paringa Resources Limited
PNTR	Pointer Telocation
PNW	Pinnacle West Capital
PODD	Insulet
POL	PolyOne
POLA	Polar Power
POOL	Pool Corporation
POPE	Pope Resources
POR	Portland General Electric Company
POST	Post Holdings
POWI	Power Integrations
POWL	Powell Industries
PPBI	Pacific Premier Bancorp
PPC	Pilgrim's Pride
PPDF	PPDAI
PPG	PPG Industries
PPHI	Positive Physicians Holdings
PPIH	Perma-Pipe International
PPL	PPL Corporation
PPSI	Pioneer Power Solutions
PPT	Putnam Premierome Trust
PQG	PQ Group
PRA	ProAssurance
PRAA	PRA Group
PRAH	PRA Health Sciences
PRCP	Perceptron
PRE	PartnerRe
PRFT	Perficient
PRGO	Perrigo Company
PRGS	Progress Software
PRGX	PRGX Global
PRI	Primerica
PRIF	Priorityome Fund
PRIM	Primoris Services
PRK	Park National
PRLB	Proto Labs
PRMW	Primo Water
PRNB	Principia Biopharma
PRO	PROS Holdings
PROV	Provident Financial
PRPH	ProPhase Labs
PRPL	Purple Innovation
PRPO	Precipio
PRQR	ProQR Therapeutics
PRSC	The Providence Service
PRSP	Perspecta
PRT	PermRock Royalty Trust
PRTA	Prothena
PRTH	Priority Technology Holdings
PRTK	Paratek Pharmaceuticals
PRTO	Proteon Therapeutics
PRTS	U.S. Auto Parts Network
PRTY	Party City Holdco
PRVB	Provention Bio
PS	Pluralsight
PSA	Public Storage
PSB	PS Business Parks
PSDO	Presidio
PSMT	PriceSmart
PSN	Parsons
PSO	Pearson
PSTG	Pure Storage
PSTI	Pluristem Therapeutics
PSTL	Postal Realty Trust
PSX	Phillips 66
PT	Pintec Technology
PTC	PTC
PTE	PolarityTE
PTEN	Patterson-UTI Energy
PTGX	Protagonist Therapeutics
PTI	Proteostasis Therapeutics
PTLA	Portola Pharmaceuticals
PTN	Palatin Technologies
PTNR	Partner Communications
PTR	PetroChina Company Limited
PTSI	P.A.M. Transportation Services
PTVCA	Protective Insurance
PUB	People's Utah Bancorp
PUK	Prudential Public
PULM	Pulmatrix
PUMP	ProPetro
PUYI	Puyi
PVAC	Penn Virginia
PVBC	Provident Bancorp
PVG	Pretium Resources
PVH	PVH
PVL	Permianville Royalty Trust
PVT	Pivotal Acquisition
PVTL	Pivotal Software
PW	Power REIT
PWOD	Penns Woods Bancorp
PWR	Quanta Services
PXD	Pioneer Natural Resources Company
PXLW	Pixelworks
PXS	Pyxis Tankers
PYDS	Payment Data Systems
PYPL	PayPal
PYS	PPlus Trust
PYX	Pyxus International
PZG	Paramount Gold Nevada
PZN	Pzena Investment Management
PZZA	Papa John's International
QADA	QAD
QBAK	Qualstar
QCOM	QUALCOMM
QCRH	QCR Holdings
QD	Qudian
QDEL	Quidel
QEP	QEP Resources
QES	Quintana Energy Services
QFIN	360 Finance, Inc.
QGEN	Qiagen
QHC	Quorum Health
QIWI	QIWI
QLYS	Qualys
QNST	QuinStreet
QRHC	Quest Resource
QRTEA	Qurate Retail
QRVO	Qorvo
QSR	Restaurant Brands International
QTNA	Quantenna Communications
QTNT	Quotient Limited
QTRH	Quarterhill
QTRX	Quanterix
QTS	QTS Realty Trust
QTT	Qutoutiao
QTWO	Q2 Holdings
QUAD	Quad Graphics
QUIK	QuickLogic
QUMU	Qumu
QUOT	Quotient Technology
QURE	uniQure
QVCD	QVC
R	Ryder System
RA	Brookfield Real Assetsome Fund
RACE	Ferrari
RAD	Rite Aid
RADA	RADA Electronic Industries
RAIL	Freightcar America
RAMP	LiveRamp
RAND	Rand Capital
RARE	Ultragenyx Pharmaceutical
RARX	Ra Pharmaceuticals
RAVE	Rave Restaurant Group
RAVN	Raven Industries
RBA	Ritchie Bros. Auctioneers
RBB	RBB Bancorp
RBBN	Ribbon Communications
RBC	Regal Beloit
RBCAA	Republic Bancorp
RBCN	Rubicon Technology
RBKB	Rhinebeck Bancorp
RBNC	Reliant Bancorp
RBS	Royal Bank Scotland
RBZ	Reebonz
RC	Ready Capital
RCG	RENN Fund
RCI	Rogers Communication
RCII	Rent-A-Center
RCKT	Rocket Pharmaceuticals
RCKY	Rocky Brands
RCL	Royal Caribbean Cruises
RCM	R1 RCM
RCMT	RCM Technologies
RCON	Recon Technology
RCUS	Arcus Biosciences
RDCM	Radcom
RDFN	Redfin
RDHL	Redhill Biopharma
RDI	Reading International
RDN	Radian Group
RDNT	RadNet
RDS.A	Royal Dutch Shell
RDUS	Radius Health
RDVT	Red Violet
RDWR	Radware
RDY	Dr. Reddy's Laboratories
RE	Everest Re Group
RECN	Resources Connection
REDU	RISE Education
REED	Reeds
REFR	Research Frontiers
REG	Regency Centers
REGI	Renewable Energy Group
REGN	Regeneron Pharmaceuticals
REI	Ring Energy
REKR	Rekor Systems
RELL	Richardson Electronics
RELV	Reliv' International
RELX	RELX
RENN	Renren
REPH	Recro Pharma
REPL	Replimune Group
RES	RPC
RESI	Front Yard Residential
RESN	Resonant
RETA	Reata Pharmaceuticals
RETO	ReTo Eco-Solutions
REV	Revlon
REVG	REV Group
REX	REX American Resources
REXR	Rexford Industrial Realty
REZI	Resideo Technologies
RF	Regions Financial
RFIL	RF Industries
RFL	Rafael Holdings
RFP	Resolute Forest Products
RGA	Reinsurance Group of America
RGCO	RGC Resources
RGEN	Repligen
RGLD	Royal Gold
RGLS	Regulus Therapeutics
RGNX	REGENXBIO
RGR	Sturm, Ruger & Company
RGS	Regis
RGT	Royce Global Value Trust
RH	RH
RHE	Regional Health Properties
RHI	Robert Half International
RHP	Ryman Hospitality Properties
RHT	Red Hat
RIBT	RiceBran Technologies
RICK	RCI Hospitality
RIF	RMR Real Estateome Fund
RIG	Transocean
RIGL	Rigel Pharmaceuticals
RILY	B. Riley Financial
RIO	Rio Tinto
RIOT	Riot Blockchain
RIVE	Riverview Financial
RJF	Raymond James Financial
RKDA	Arcadia Biosciences
RL	Ralph Lauren
RLGT	Radiant Logistics
RLGY	Realogy
RLH	Red Lion Hotels
RLI	RLI
RLJ	RLJ Lodging Trust
RLM	Realm Therapeutics
RM	Regional Management
RMAX	RE/MAX
RMBL	RumbleOn
RMBS	Rambus
RMCF	Rocky Mountain Chocolate Factory
RMD	ResMed
RMED	Ra Medical Systems
RMG	RMG Acquisition
RMNI	Rimini Street
RMPL	RiverNorth Marketplace Lending
RMR	The RMR Group
RMT	Royce Micro-Cap Trust
RMTI	Rockwell Medical
RNDB	Randolph Bancorp
RNET	RigNet
RNG	Ringcentral
RNGR	Ranger Energy Services
RNN	Rexahn Pharmaceuticals
RNR	RenaissanceRe
RNST	Renasant
RNWK	RealNetworks
ROAD	Construction Partners
ROAN	Roan Resources
ROBO	Exchange Traded Concepts Trust ROBO Global Robotics and Automa
ROCK	Gibraltar Industries
ROG	Rogers
ROIC	Retail Opportunity Investments
ROK	Rockwell Automation
ROKU	Roku
ROL	Rollins
ROLL	RBC Bearings
ROP	Roper Technologies
ROSE	Rosehill Resources
ROST	Ross Stores
ROX	Castle Brands
ROYT	Pacific Coast Oil Trust
RP	RealPage
RPAI	Retail Properties of America
RPD	Rapid7
RPLA	Replay Acquisition
RPM	RPM International
RPT	RPT Realty
RRBI	Red River Bancshares
RRC	Range Resources
RRD	R.R. Donnelley & Sons
RRGB	Red Robin Gourmet Burgers
RRR	Red Rock Resorts
RRTS	Roadrunner Transportation Systems
RS	Reliance Steel & Aluminum
RSG	Republic Services
RST	Rosetta Stone
RTEC	Rudolph Technologies
RTIX	RTI Surgical
RTLR	Rattler Midstream
RTN	Raytheon Company
RTRX	Retrophin
RTTR	Ritter Pharmaceuticals
RTW	RTW Retailwinds
RUBI	The Rubicon Project
RUBY	Rubius Therapeutics
RUHN	Ruhnn
RUN	Sunrun
RUSHA	Rush Enterprises
RUTH	Ruth's Hospitality Group
RVEN	Reven Housing REIT
RVI	Retail Value
RVLT	Revolution Lighting Technologies
RVNC	Revance Therapeutics
RVP	Retractable Technologies
RVSB	Riverview Bancorp
RVT	Royce Value Trust
RWGE	Regalwood Global Energy
RWLK	ReWalk Robotics
RWT	Redwood Trust
RXN	Rexnord
RY	Royal Bank Of Canada
RYAAY	Ryanair
RYAM	Rayonier Advanced Materials
RYB	RYB Education
RYI	Ryerson
RYN	Rayonier
RYTM	Rhythm Pharmaceuticals
S	Sprint
SA	Seabridge Gold
SAB	Saratoga Investment
SABR	Sabre
SACH	Sachem Capital
SAEX	SAExploration
SAFE	Safehold
SAFM	Sanderson Farms
SAFT	Safety Insurance Group
SAGE	Sage Therapeutics
SAH	Sonic Automotive
SAIA	Saia
SAIC	SCIENCE APPLICATIONS INTERNATIONAL
SAIL	SailPoint Technologies
SAL	Salisbury Bancorp
SALM	Salem Media Group
SALT	Scorpio Bulkers
SAM	Boston Beer Company
SAMA	Schultze Special Purpose Acquisition
SAMG	Silvercrest Asset Management Group
SAN	Banco Santander
SAND	Sandstorm Gold
SANM	Sanmina
SANW	S&W Seed
SAP	SAP SE
SASR	Sandy Spring Bancorp
SATS	EchoStar
SAUC	Diversified Restaurant Holdings
SAVA	Cassava Sciences
SAVE	Spirit Airlines
SB	Safe Bulkers
SBAC	SBA Communications
SBBP	Strongbridge Biopharma
SBBX	SB One Bancorp
SBCF	Seacoast Banking of Florida
SBFG	SB Financial
SBGI	Sinclair Broadcast
SBGL	Sibanye Gold
SBH	Sally Beauty
SBLK	Star Bulk Carriers
SBNA	Scorpio Tankers
SBNY	Signature Bank
SBOT	Stellar Biotechnologies
SBOW	SilverBow Resorces
SBPH	Spring Bank Pharmaceuticals
SBR	Sabine Royalty Trust
SBRA	Sabra Health Care REIT
SBS	Companhia de saneamento Basico Do Estado De Sao Paulo
SBSI	Southside Bancshares
SBT	Sterling Bancorp
SBUX	Starbucks
SC	Santander
SCA	Stellus Capital Investment
SCCO	Southern Copper
SCD	LMP Capital andome Fund
SCE	Southern California Edison Company
SCHL	Scholastic
SCHN	Schnitzer Steel Industries
SCHW	The Charles Schwab
SCI	Service International
SCKT	Socket Mobile
SCL	Stepan Company
SCON	Superconductor Technologies
SCOR	comScore
SCPH	scPharmaceuticals
SCPL	SciPlay
SCS	Steelcase
SCSC	ScanSource
SCVL	Shoe Carnival
SCWX	SecureWorks
SCX	L.S. Starrett
SCYX	SCYNEXIS
SD	SandRidge Energy
SDI	Standard Diversified
SDLP	Seadrill Partners
SDPI	Superior Drilling Products
SDRL	Seadrill
SDT	SandRidge Mississippian Trust
SE	Sea Limited
SEAC	SeaChange International
SEAS	SeaWorld Entertainment
SEB	Seaboard
SECO	Secoo
SEDG	SolarEdge Technologies
SEE	Sealed Air
SEED	Origin Agritech
SEEL	Seelos Therapeutics
SEIC	SEI Investments
SELB	Selecta Biosciences
SELF	Global Self Storage
SEM	Select Medical Holdings
SEMG	Semgroup
SENEA	Seneca Foods
SENS	Senseonics
SERV	ServiceMaster Global
SES	Synthesis Energy Systems
SESN	Sesen Bio
SF	Stifel Financial
SFBS	ServisFirst Bancshares
SFE	Safeguard Scientifics
SFET	Safe-T Group
SFIX	Stitch Fix
SFL	Ship Finance International Limited
SFLY	Shutterfly
SFM	Sprouts Farmers Market
SFNC	Simmons First National
SFST	Southern First Bancshares
SFUN	Fang Holdings
SG	Sirius International Insurance Group
SGA	Saga Communications
SGB	Southwest Georgia Financial
SGBX	SG Blocks
SGC	Superior Group of Companies
SGEN	Seattle Genetics
SGH	SMART Global Holdings
SGLB	Sigma Labs
SGMA	SigmaTron International
SGMO	Sangamo Therapeutics
SGMS	Scientific Games
SGOC	SGOCO Group
SGRP	SPAR Group
SGRY	Surgery Partners
SGU	Star Group
SHAK	Shake Shack
SHBI	Shore Bancshares
SHEN	Shenandoah Telecommunications
SHG	Shinhan Financial Group
SHI	SINOPEC Shangai Petrochemical
SHIP	Seanergy Maritime
SHLL	Tortoise Acquisition
SHLO	Shiloh Industries
SHLX	Shell Midstream Partners
SHO	Sunstone Hotel
SHOO	Steven Madden
SHOP	Shopify
SHOS	Sears
SHSP	SharpSpring
SHW	Sherwin-Williams Company
SIBN	SI-BONE
SIC	Select Interior Concepts
SIEB	Siebert Financial
SIEN	Sientra
SIF	SIFCO Industries
SIFY	Sify Technologies
SIG	Signet Jewelers
SIGA	SIGA Technologies
SIGI	Selective Insurance Group
SILC	Silicom
SILK	Silk Road Medical
SILV	SilverCrest Metals
SIM	Grupo Simec
SIMO	Silicon Motion Technology
SINA	Sina
SINO	Sino-Global Shipping America
SINT	SiNtx Technologies
SIRI	Sirius XM
SITC	SITE Centers
SITE	SiteOne Landscape Supply
SITO	SITO Mobile
SIVB	SVB Financial Group
SIX	Six Flags Entertainment New
SJI	South Jersey Industries
SJM	J.M. Smucker
SJR	Shaw Communications
SJT	San Juan Basin Royalty Trust
SJW	SJW Group
SKIS	Peak Resorts
SKM	SK Telecom
SKT	Tanger Factory Outlet Centers
SKX	Skechers U.S.A.
SKY	Skyline Champion
SKYS	Sky Solar Holdings
SKYW	SkyWest
SLAB	Silicon Laboratories
SLB	Schlumberger
SLCA	U.S. Silica
SLCT	Select Bancorp
SLDB	Solid Biosciences
SLF	Sun Life Financial
SLG	SL Green Realty
SLGG	Super League Gaming
SLGL	Sol-Gel Technologies
SLGN	Silgan
SLIM	The Obesity ETF
SLM	SLM Corporation
SLNO	Soleno Therapeutics
SLP	Simulations Plus
SLRC	Solar Capital
SLS	SELLAS Life Sciences Group
SM	SM Energy Company
SMAR	Smartsheet
SMBC	Southern Missouri Bancorp
SMBK	SmartFinancial
SMCP	AlphaMark Actively Managed Small Cap ETF
SMED	Sharps Compliance
SMFG	Sumitomo Mitsui Financial Group
SMG	Scotts Miracle-Gro
SMHI	SEACOR Marine
SMI	Semiconductor Manufacturing International
SMIT	Schmitt Industries
SMLP	Summit Midstream Partners
SMM	Salient Midstream & MLP Fund
SMMF	Summit Financial Group
SMMT	Summit Therapeutics
SMP	Standard Motor Products
SMPL	The Simply Good Foods Company
SMRT	Stein Mart
SMSI	Smith Micro Software
SMTA	Spirit MTA REIT
SMTC	Semtech
SMTS	Sierra Metals
SMTX	SMTC
SNA	Snap-On
SNAP	Snap Inc.
SNBR	Sleep Number
SNCR	Synchronoss Technologies
SND	Smart Sand
SNDE	Sundance Energy Australia Limited
SNDR	Schneider National
SNDX	Syndax Pharmaceuticals
SNE	Sony
SNES	SenesTech
SNFCA	Security National Financial
SNGX	Soligenix
SNH	Senior Housing Properties Trust
SNHY	Sun Hydraulics
SNMP	Sanchez Midstream Partners
SNN	Smith & Nephew SNATS
SNNA	Sienna Biopharmaceuticals
SNOA	Sonoma Pharmaceuticals
SNP	China Petroleum & Chemical
SNPS	Synopsys
SNR	New Senior Investment Group
SNSS	Sunesis Pharmaceuticals
SNV	Synovus Financial
SNX	Synnex
SNY	Sanofi
SO	Southern Company
SOGO	Sogou
SOHO	Sotherly Hotels
SOHU	Sohu.com
SOI	Solaris Oilfield Infrastructure
SOL	Renesola
SOLO	Electrameccanica Vehicles
SOLY	Soliton
SON	Sonoco Products Company
SONA	Southern National Bancorp of Virginia
SONM	Sonim Technologies
SONO	Sonos
SOR	Source Capital
SORL	SORL Auto Parts
SP	SP Plus
SPAQ	Spartan Energy Acquisition
SPAR	Spartan Motors
SPB	Spectrum Brands
SPCB	SuperCom
SPE	Special Opportunities Fund
SPEX	Spherix
SPFI	South Plains Financial
SPG	Simon Property Group
SPGI	S&P Global
SPH	Suburban Propane Partners
SPHS	Sophiris Bio
SPI	SPI Energy
SPKE	Spark Energy
SPLK	Splunk
SPLP	Steel Partners
SPN	Superior Energy Services
SPNE	SeaSpine
SPNS	Sapiens International
SPOK	Spok
SPOT	Spotify
SPPI	Spectrum Pharmaceuticals
SPR	Spirit Aerosystems
SPRO	Spero Therapeutics
SPRT	support.com
SPSC	SPS Commerce
SPTN	SpartanNash Company
SPWH	Sportsman's Warehouse
SPWR	SunPower
SPXC	SPX
SQ	Square
SQBG	Sequential Brands Group
SQM	Sociedad Quimica y Minera
SQNS	Sequans Communications
SR	Spire
SRAX	Social Reality
SRC	Spirit Realty Capital
SRCE	1st Source
SRCI	SRC Energy
SRCL	Stericycle
SRDX	Surmodics
SRE	Sempra Energy
SREV	ServiceSource International
SRF	Cushing Energyome Fund
SRG	Seritage Growth Properties
SRI	Stoneridge
SRLP	Sprague Resources
SRNE	Sorrento Therapeutics
SRPT	Sarepta Therapeutics
SRRA	Sierra Oncology
SRRK	Scholar Rock Holding
SRT	StarTek
SRTS	Sensus Healthcare
SRV	Cushing MLP & Infrastructure Total Return Fund
SSB	South State
SSBI	Summit State Bank
SSD	Simpson Manufacturing
SSFN	Stewardship Financial
SSI	Stage Stores
SSKN	Strata Skin Sciences
SSL	Sasol
SSNC	SS&C Technologies
SSNT	SilverSun Technologies
SSP	E.W. Scripps Company
SSRM	SSR Mining
SSTI	ShotSpotter
SSTK	Shutterstock
SSW	Seaspan
SSY	SunLink Health Systems
SSYS	Stratasys
ST	Sensata Technologies
STAA	STAAR Surgical Company
STAF	Staffing 360 Solutions
STAG	Stag Industrial
STAR	iStar
STAY	Extended Stay America
STBA	S&T Bancorp
STC	Stewart Information Services
STCN	Steel Connect
STE	STERIS
STFC	State Auto Financial
STG	Sunlands Technology Group
STI	SunTrust Banks
STK	Columbia Seligman Premium Technology Growth Fund
STKL	SunOpta
STKS	The ONE Group Hospitality
STL	Sterling Bancorp
STLD	Steel Dynamics
STM	STMicroelectronics N.V.
STML	Stemline Therapeutics
STMP	Stamps.com
STN	Stantec
STND	Standard AVB Financial
STNE	StoneCo
STNL	Sentinel Energy Services
STON	StoneMor Partners
STOR	STORE Capital
STRA	Strategic Education
STRL	Sterling Construction Company
STRM	Streamline Health Solutions
STRO	Sutro Biopharma
STRS	Stratus Properties
STRT	Strattec Security
STT	State Street
STWD	STARWOOD PROPERTY TRUST
STX	Seagate Technology
STXB	Spirit of Texas Bancshares
STZ	Constellation Brands
SU	Suncor Energy
SUI	Sun Communities
SUM	Summit Materials
SUMR	Summer Infant
SUN	Sunoco
SUNS	Solar Senior Capital
SUNW	Sunworks
SUP	Superior Industries International
SUPN	Supernus Pharmaceuticals
SUPV	Grupo Supervielle
SURF	Surface Oncology
SUZ	Suzano
SVA	Sinovac Biotech
SVBI	Severn Bancorp
SVM	Silvercorp Metals
SVMK	SVMK
SVRA	Savara
SVT	Servotronics
SVVC	Firsthand Technology Value Fund
SWAV	ShockWave Medical
SWCH	Switch, Inc.
SWI	SolarWinds
SWIR	Sierra Wireless
SWJ	Stanley Black & Decker
SWKS	Skyworks Solutions
SWM	Schweitzer-Mauduit International
SWN	Southwestern Energy Company
SWX	Southwest Gas
SWZ	Swiss Helvetia Fund
SXC	SunCoke Energy
SXCP	SunCoke Energy Partners
SXI	Standex International
SXT	Sensient Technologies
SXTC	China SXT Pharmaceuticals
SY	So-Young International
SYBT	Stock Yards Bancorp
SYBX	Synlogic
SYF	Synchrony Financial
SYK	Stryker
SYKE	Sykes Enterprises
SYMC	Symantec
SYN	Synthetic Biologics
SYNA	Synaptics
SYNC	Synacor
SYNH	Syneos Health
SYNL	Synalloy
SYPR	Sypris Solutions
SYRS	Syros Pharmaceuticals
SYX	Systemax
SYY	Sysco
SZC	Cushing Renaissance Fund
T	AT&T
TA	TravelCenters of America
TAC	TransAlta
TACO	Del Taco Restaurants
TACT	TransAct Technologies
TAIT	Taitron Components
TAK	Takeda Pharmaceutical
TAL	TAL Education Group
TALO	Talos Energy
TANH	Tantech
TAOP	Taoping
TAP	Molson Coors
TARO	Taro Pharmaceutical Industries
TAST	Carrols Restaurant
TAT	Transatlantic Petroleum
TATT	TAT Technologies
TAYD	Taylor Devices
TBBK	The Bancorp
TBI	TrueBlue
TBIO	Translate Bio
TBK	Triumph Bancorp
TBLT	ToughBuilt Industries
TBNK	Territorial Bancorp
TBPH	Theravance Biopharma
TBRG	Thunder Bridge Acquisition
TC	TuanChe Limited
TCBI	Texas Capital Bancshares
TCBK	TriCo Bancshares
TCCO	Technical Communications
TCDA	Tricida
TCF	TCF Financial
TCFC	The Community Financial
TCI	Transcontinental Realty Investors
TCMD	Tactile Systems Technology
TCO	Taubman Centers
TCON	TRACON Pharmaceuticals
TCP	TC PipeLines
TCRD	THL Credit
TCRR	TCR2 Therapeutics
TCS	Container Store
TCX	Tucows
TD	Toronto Dominion Bank
TDA	Telephone and Data Systems
TDAC	Trident Acquisitions
TDC	Teradata
TDF	Templeton Dragon Fund
TDG	Transdigm Group
TDOC	Teladoc Health
TDW	Tidewater
TDY	Teledyne Technologies
TEAF	Tortoise Essential Assetsome Term Fund
TEAM	Atlassian
TECD	Tech Data Corporation
TECH	Bio-Techne
TECK	Teck Resources
TECTP	Tectonic Financial
TEDU	Tarena International
TEF	Telefonica
TEI	Templeton Emerging Marketsome Fund
TEL	TE Connectivity
TELL	Tellurian
TEN	Tenneco
TENB	Tenable
TENX	Tenax Therapeutics
TEO	Telecom Argentina Stet - France Telecom
TER	Teradyne
TERP	TerraForm Power
TESS	TESSCO
TEUM	Pareteum
TEVA	Teva Pharmaceutical
TEX	Terex
TFSL	TFS Financial
TFX	Teleflex
TG	Tredegar
TGA	TransGlobe Energy
TGB	Taseko Mines Limited
TGC	Tengasco
TGE	Tallgrass Energy
TGEN	Tecogen
TGH	Textainer Group
TGI	Triumph Group
TGLS	Tecnoglass
TGP	Teekay LNG Partners
TGS	Transportadora
TGT	Target Corporation
TGTX	TG Therapeutics
TH	Target Hospitality
THC	Tenet Healthcare
THCB	Tuscan Holdings
THFF	First Financial Indiana
THG	The Hanover Insurance Group
THM	International Tower Hill Mines Ltd
THO	Thor Industries
THOR	Synthorx
THQ	Tekla Healthcare Opportunies Fund
THR	Thermon Group
THRM	Gentherm
THS	Treehouse Foods
THW	Tekla World Healthcare Fund
TI	Telecom Italia
TIBR	Tiberius Acquisition
TIER	TIER REIT
TIF	Tiffany
TIGO	Millicom International Cellular
TIGR	UP Fintech
TILE	Interface Inc
TIPT	Tiptree
TISI	Team, Inc.
TITN	Titan Machinery
TIVO	TiVo
TJX	TJX
TK	Teekay
TKAT	Takung Art
TKC	Turkcell Iletisim Hizmetleri
TKKS	TKK Symphony Acquisition
TKR	Timken
TLC	Taiwan Liposome Company
TLF	Tandy Leather Factory
TLGT	Teligent
TLK	PT Telekomunikasi
TLND	Talend
TLRA	Telaria
TLRD	Tailored Brands
TLRY	Tilray
TLSA	Tiziana Life Sciences
TLYS	Tilly's
TM	Toyota
TMCX	Trinity Merger
TMDI	Titan Medical
TMDX	TransMedics Group
TME	Tencent Music Entertainment Group
TMHC	Taylor Morrison Home
TMK	Torchmark
TMO	Thermo Fisher Scientific
TMP	Tompkins Financial
TMQ	Trilogy Metals
TMSR	TMSR
TMST	TimkenSteel
TMUS	T-Mobile
TNAV	Telenav
TNC	Tennant Company
TNDM	Tandem Diabetes Care
TNET	TriNet Group
TNK	Teekay Tankers
TNP	Tsakos Energy Navigation
TNXP	Tonix Pharmaceuticals
TOCA	Tocagen
TOL	Toll Brothers
TOO	Teekay Offshore Partners
TOPS	TOP Ships
TORC	resTORbio
TOT	Total S.A.
TOTA	Tottenham Acquisition
TOUR	Tuniu
TOWN	Towne Bank
TOWR	Tower International
TPB	Turning Point Brands
TPC	Tutor Perini
TPCO	Tribune Publishing
TPGH	TPG Pace
TPH	TRI Pointe
TPHS	Trinity Place
TPIC	TPI Composites
TPL	Texas Pacific Land Trust
TPR	Tapestry
TPRE	Third Point Reinsurance
TPTX	Turning Point Therapeutics
TPVG	TriplePoint Venture Growth BDC
TPX	Tempur Sealy International
TPZ	Tortoise Power and Energy Infrastructure Fund
TR	Tootsie Roll Industries
TRC	Tejon Ranch
TRCB	Two River Bancorp
TRCH	Torchlight Energy Resources
TRCO	Tribune Media Company
TREC	Trecora Resources
TREE	LendingTree
TREX	Trex Company
TRGP	Targa Resources
TRHC	Tabula Rasa HealthCare
TRI	Thomson Reuters
TRIB	Trinity Biotech
TRIL	Trillium Therapeutics
TRIP	TripAdvisor
TRK	Speedway Motorsports
TRMB	Trimble
TRMD	TORM
TRMK	Trustmark
TRMT	Tremont Mortgage Trust
TRN	Trinity Industries
TRNE	Trine Acquisition
TRNO	Terreno Realty
TRNS	Transcat
TRNX	Taronis
TROV	TrovaGene
TROW	T. Rowe Price
TROX	Tronox
TRP	TC Energy
TRPX	Therapix Biosciences
TRQ	Turquoise Hill Resources
TRS	TriMas
TRST	TrustCo Bank
TRT	Trio-Tech International
TRTN	Triton International Limited
TRTX	TPG RE Finance Trust
TRU	TransUnion
TRUP	Trupanion
TRV	The Travelers Companies
TRVG	trivago
TRVI	Trevi Therapeutics
TRVN	Trevena
TRWH	Twin River Worldwide
TRX	Tanzanian Gold
TRXC	TransEnterix
TS	Tenaris
TSBK	Timberland Bancorp
TSC	TriState Capital
TSCO	Tractor Supply Company
TSE	Trinseo
TSEM	Tower Semiconductor
TSG	The Stars Group
TSI	TCW Strategicome Fund
TSLA	Tesla
TSLF	THL Credit Senior Loan Fund
TSLX	TPG Specialty Lending
TSM	Taiwan Semiconductor Manufacturing Company
TSN	Tyson Foods
TSQ	Townsquare Media
TSRI	TSR
TSS	Total System Services
TST	TheStreet
TSU	TIM Participacoes
TTC	Toro Company
TTD	The Trade Desk
TTEC	TTEC Holdings
TTEK	Tetra Tech
TTGT	TechTarget
TTI	Tetra Technologies
TTM	Tata Motors
TTMI	TTM Technologies
TTNP	Titan Pharmaceuticals
TTOO	T2 Biosystems
TTP	Tortoise Pipeline & Energy Fund
TTPH	Tetraphase Pharmaceuticals
TTS	Tile Shop Hldgs
TTTN	TigerShares China-U.S. Internet Titans ETF
TTWO	Take-Two Interactive Software
TU	TELUS
TUES	Tuesday Morning
TUFN	Tufin Software Technologies
TUP	Tupperware Brands
TURN	180 Degree Capital
TUSK	Mammoth Energy Services
TV	Grupo Televisa
TVC	Tennessee Valley Authority
TVPT	Travelport Worldwide Limited
TVTY	Tivity Health
TW	Tradeweb Markets
TWI	Titan International
TWIN	Twin Disc
TWLO	Twilio
TWMC	Trans World Entertainment
TWN	Taiwan Fund
TWNK	Hostess Brands
TWO	Two Harbors Investments Corp
TWOU	2U
TWST	Twist Bioscience
TWTR	Twitter
TX	Ternium
TXMD	TherapeuticsMD
TXN	Texas Instruments
TXRH	Texas Roadhouse
TXT	Textron
TY	Tri Continental
TYG	Tortoise Energy Infrastructure
TYHT	Shineco
TYL	Tyler Technologies
TYME	Tyme Technologies
TYPE	Monotype Imaging
TZAC	Tenzing Acquisition
TZOO	Travelzoo
UA	Under Armour
UAL	United Continental Holdings
UAMY	United States Antimony
UAN	CVR Partners
UAVS	AgEagle Aerial Systems
UBA	Urstadt Biddle Properties
UBCP	United Bancorp
UBER	Uber Technologies
UBFO	United Security Bancshares
UBNK	United Financial Bancorp
UBNT	Ubiquiti Networks
UBOH	United Bancshares
UBS	UBS
UBX	Unity Biotechnology
UCBI	United Community Banks
UCFC	United Community Financial
UCTT	Ultra Clean Holdings
UDR	UDR
UE	Urban Edge Properties
UEC	Uranium Energy
UEIC	Universal Electronics
UEPS	Net 1 UEPS Technologies
UFAB	Unique Fabricating
UFCS	United Fire Group
UFI	Unifi
UFPI	Universal Forest Products
UFPT	UFP Technologies
UFS	Domtar
UG	United-Guardian
UGI	UGI
UGP	Ultrapar Participacoes
UHAL	Amerco
UHS	Universal Health Services
UHT	Universal Health Realtyome Trust
UIHC	United Insurance Holdings
UIS	Unisys
UL	Unilever
ULBI	Ultralife
ULH	Universal Logistics Holdings
ULTA	Ulta Beauty
UMBF	UMB Financial
UMC	United Microelectronics
UMH	UMH Properties
UMPQ	Umpqua
UMRX	Unum Therapeutics
UN	Unilever NV
UNAM	Unico American
UNB	Union Bankshares
UNF	Unifirst
UNFI	United Natural Foods
UNH	UnitedHealth Group
UNIT	Uniti Group
UNM	Unum Group
UNP	Union Pacific
UNT	Unit Corporation
UNTY	Unity Bancorp
UNVR	Univar
UONE	Urban One
UPL	Ultra Petroleum
UPLD	Upland Software
UPS	United Parcel Service
UPWK	Upwork
UQM	UQM Technologies
URBN	Urban Outfitters
URG	Ur Energy
URGN	UroGen Pharma
URI	United Rentals
UROV	Urovant Sciences
USAC	USA Compression Partners
USAK	USA Truck
USAP	Universal Stainless & Alloy Products
USAS	Americas Silver
USAT	USA Technologies
USAU	U.S. Gold
USB	U.S. Bancorp
USCR	U S Concrete
USDP	USD Partners
USEG	U.S. Energy
USFD	US Foods Holding
USLM	United States Lime & Minerals
USM	United States Cellular
USNA	USANA Health Sciences
USPH	U.S. Physical Therapy
USWS	U.S. Well Services
USX	U.S. Xpress Enterprises
UTG	Reaves Utilityome Fund
UTHR	United Therapeutics
UTI	Universal Technical Institute
UTL	UNITIL
UTMD	Utah Medical Products
UTSI	UTStarcom
UTX	United Technologies
UUU	Universal Security Instruments
UUUU	Energy Fuels
UVE	UNIVERSAL INSURANCE HOLDINGS
UVSP	Univest Financial
UVV	Universal Corporation
UWN	Nevada Gold & Casinos
UXIN	Uxin Limited
V	Visa Inc.
VAC	Marriott Vacations Worldwide
VALE	VALE
VALU	Value Line
VAM	The Vivaldi Opportunities Fund
VAPO	Vapotherm
VAR	Varian Medical Systems
VBFC	Village Bank and Trust Financial
VBIV	VBI Vaccines
VBLT	Vascular Biogenics
VBTX	Veritex
VC	Visteon
VCEL	Vericel
VCF	Delaware Investments Colorado Municipalome Fund
VCNX	Vaccinex
VCRA	Vocera Communications
VCTR	Victory Capital Holdings
VCYT	Veracyte
VEC	Vectrus
VECO	Veeco Instruments
VEDL	Vedanta Limited
VEEV	Veeva Systems
VEON	VEON
VER	VEREIT
VERB	Verb Technology
VERI	Veritone
VERU	Veru
VET	Vermilion Energy
VFC	V.F. Corporation
VFF	Village Farms International
VFL	Delaware Investments Florida Insured Municipalome Fund
VG	Vonage
VGR	Vector Group
VGZ	Vista Gold
VHC	VirnetX
VHI	Valhi
VIA	Viacom
VIAV	Viavi Solutions
VICI	VICI Properties
VICL	Vical
VICR	Vicor
VIOT	Viomi Technology
VIPS	Vipshop
VIRC	Virco Manufacturing
VIRT	Virtu Financial
VISI	Volt Information Sciences
VISL	Vislink Technologies
VIV	Telefonica Brasil
VIVE	Viveve Medical
VIVO	Meridian Bioscience
VJET	voxeljet
VKTX	Viking Therapeutics
VLGEA	Village Super Market
VLO	Valero Energy
VLRS	Controladora Vuela Compania de Aviacion
VLRX	Valeritas
VLY	Valley National Bancorp
VMC	Vulcan Materials
VMI	Valmont Industries
VMM	Delaware Investments Minnesota Municipalome Fund
VMW	Vmware
VNCE	Vince
VNDA	Vanda Pharmaceuticals
VNE	Veoneer
VNET	21Vianet
VNO	Vornado Realty Trust
VNOM	Viper Energy Partners
VNRX	VolitionRX Limited
VNTR	Venator Materials
VOC	VOC Energy Trust
VOD	Vodafone Group
VOXX	VOXX International
VOYA	Voya Financial
VPG	Vishay Precision Group
VRA	Vera Bradley
VRAY	ViewRay
VRCA	Verrica Pharmaceuticals
VREX	Varex Imaging
VRML	Vermillion
VRNA	Verona Pharma
VRNS	Varonis Systems
VRNT	Verint Systems
VRRM	Verra Mobility
VRS	Verso
VRSK	Verisk Analytics
VRSN	VeriSign
VRTU	Virtusa
VRTV	Veritiv
VRTX	Vertex Pharmaceuticals
VSAT	ViaSat
VSEC	VSE
VSH	Vishay Intertechnology
VSI	Vitamin Shoppe
VSLR	Vivint Solar
VSM	Versum Materials
VST	Vistra Energy
VSTM	Verastem
VSTO	Vista Outdoor
VTGN	VistaGen Therapeutics
VTIQ	VectoIQ Acquisition
VTNR	Vertex Energy
VTR	Ventas
VTSI	VirTra
VTVT	vTv Therapeutics
VUZI	Vuzix
VVI	Viad
VVPR	VivoPower International
VVUS	VIVUS
VVV	Valvoline
VXRT	Vaxart
VYGR	Voyager Therapeutics
VZ	Verizon Communications
W	Wayfair
WAAS	AquaVenture
WAB	Westinghouse Air Brake Technologies
WABC	Westamerica Bancorporation
WAFD	Washington Federal
WAFU	Wah Fu Education Group
WAGE	WageWorks
WAIR	Wesco Aircraft
WAL	Western Alliance Bancorporation
WASH	Washington Trust Bancorp
WAT	Waters Corporation
WATT	Energous
WB	Weibo
WBA	Walgreens Boots Alliance
WBAI	500.com
WBC	Wabco
WBK	Westpac Banking
WBS	Webster Financial
WBT	Welbilt
WCC	WESCO International
WCFB	WCF Bancorp
WCG	WellCare Health Plans
WCN	Waste Connections
WD	Walker & Dunlop
WDAY	Workday
WDC	Western Digital
WDFC	WD-40 Company
WDR	Waddell & Reed Financial
WEBK	Wellesley Bancorp
WEC	WEC Energy
WEI	Weidai
WELL	Welltower
WEN	Wendy's
WERN	Werner Enterprises
WES	Western Midstream Partners
WETF	WisdomTree Investments
WEX	WEX
WEYS	Weyco Group
WF	Woori Bank
WFC	Wells Fargo
WGO	Winnebago Industries
WH	Wyndham Hotels & Resorts
WHD	Cactus, Inc.
WHF	WhiteHorse Finance
WHG	Westwood Holdings
WHLM	Wilhelmina International
WHLR	Wheeler Real Estate Investment Trust
WHR	Whirlpool
WIFI	Boingo Wireless
WILC	G. Willi-Food International
WINA	Winmark
WING	Wingstop
WINS	Wins Finance
WIRE	Encore Wire
WISA	Summit Wireless Technologies
WIT	Wipro Limited
WIX	Wix.com
WK	Workiva
WKHS	Workhorse Group
WLDN	Willdan Group
WLFC	Willis Lease Finance
WLH	Lyon William Homes
WLK	Westlake Chemical
WLKP	Westlake Chemical Partners
WLL	Whiting Petroleum
WLTW	Willis Towers Watson Public Limited Company
WM	Waste Management
WMB	Williams Companies
WMGI	Wright Medical Group
WMK	Weis Markets
WMS	Advanced Drainage Systems
WMT	Walmart
WNC	Wabash National
WNEB	Western New England Bancorp
WNS	WNS
WOR	Worthington Industries
WORX	SCWorx
WOW	WideOpenWest
WP	Worldpay
WPC	W.P. Carey
WPG	Washington Prime Group
WPM	Wheaton Precious Metals
WPP	WPP
WPRT	Westport Fuel Systems
WPX	WPX Energy
WRB	W.R. Berkley
WRE	Washington Real Estate Investment Trust
WRI	Weingarten Realty Investors
WRK	Westrock Company
WRLD	World Acceptance
WRLS	Pensare Acquisition
WRN	Western Copper and Gold
WRTC	Wrap Technologies
WSBC	WesBanco
WSBF	Waterstone Financial
WSC	WillScot
WSFS	WSFS Financial
WSM	Williams-Sonoma
WSO	Watsco
WSR	Whitestone REIT
WST	West Pharmaceutical Services
WSTG	Wayside Technology Group
WSTL	Westell Technologies
WTBA	West Bancorporation
WTER	The Alkaline Water
WTFC	Wintrust Financial
WTI	W&T Offshore
WTM	White Mountains Insurance Group
WTR	Aqua America
WTRE	Watford Holdings
WTRH	Waitr
WTS	Watts Water Technologies
WTT	Wireless Telecom Group
WTTR	Select Energy Services
WU	Western Union
WUBA	58.com
WVE	WAVE Life Sciences
WVFC	WVS Financial
WVVI	Willamette Valley Vineyards
WW	Weight Watchers International
WWD	Woodward
WWE	World Wrestling Entertainment
WWR	Westwater Resources
WWW	Wolverine World Wide
WY	Weyerhaeuser
WYND	Wyndham Destinations
WYNN	Wynn Resorts, Limited
WYY	WidePoint
X	United States Steel
XAN	Exantas Capital
XBIO	Xenetic Biosciences
XBIT	XBiotech
XEC	Cimarex Energy
XEL	Xcel Energy
XELA	Exela Technologies
XELB	Xcel Brands
XENE	Xenon Pharmaceuticals
XENT	Intersect ENT
XERS	Xeris Pharmaceuticals
XFLT	XAI Octagon Floating Rate & Alternativeome Term Trust
XFOR	X4 Pharmaceuticals
XHR	Xenia Hotels & Resorts
XIN	Xinyuan Real Estate
XLNX	Xilinx
XLRN	Acceleron Pharma
XNCR	Xencor
XNET	Xunlei Limited
XOG	Extraction Oil & Gas
XOM	Exxon Mobil
XOMA	XOMA
XON	Intrexon
XONE	The ExOne
XPER	Xperi
XPL	Solitario Zinc
XPO	XPO Logistics
XRAY	DENTSPLY SIRONA
XRF	China Rapid Finance
XRX	Xerox
XSPA	XpresSpa
XTLB	XTL Biopharmaceuticals
XTNT	Xtant Medical
XXII	22nd Century Group
XYF	X Financial
XYL	Xylem
XYN	Xynomic Pharmaceuticals
Y	Alleghany
YCBD	cbdMD
YELP	Yelp
YETI	YETI
YEXT	Yext
YGTY	SSLJ.com
YGYI	Youngevity International
YI	111, Inc.
YIN	Yintech Investment
YJ	Yunji
YMAB	Y-mAbs Therapeutics
YNDX	Yandex
YOGA	YogaWorks
YORW	The York Water Company
YPF	YPF Sociedad Anonima
YRCW	YRC Worldwide
YRD	Yirendai
YRIV	Yangtze River Port and Logistics
YTEN	Yield10 Bioscience
YTRA	Yatra Online
YUM	Yum! Brands
YUMA	Yuma Energy
YUMC	Yum China
YVR	Liquid Media Group
YY	YY Inc.
Z	Zillow
ZAGG	ZAGG
ZAYO	Zayo Group
ZB	Zions Bancorporation
ZBH	Zimmer Biomet
ZBRA	Zebra Technologies
ZDGE	Zedge
ZEAL	Zealand Pharma
ZEN	Zendesk
ZEUS	Olympic Steel
ZFGN	Zafgen
ZGNX	Zogenix
ZIOP	ZIOPHARM Oncology
ZIXI	Zix
ZKIN	ZK International Group
ZLAB	Zai Lab
ZM	Zoom Video Communications
ZN	Zion Oil & Gas
ZNGA	Zynga
ZNH	China Southern Airlines
ZOM	Zomedica Pharmaceuticals
ZS	Zscaler
ZSAN	Zosano Pharma
ZTEST	BATS BZX Exchange
ZTO	ZTO Express
ZTS	Zoetis
ZUMZ	Zumiez
ZUO	Zuora
ZVO	Zovio
ZYME	Zymeworks
ZYNE	Zynerba Pharmaceuticals
ZYXI	Zynex
TRUE	TrueCar